samplename	group	barcode	index
CTGCGT_TAAGGCGA	TAAGGCGA	CTGCGT	TAAGGCGA
GCTGCA_TAAGGCGA	TAAGGCGA	GCTGCA	TAAGGCGA
CGATAC_TAAGGCGA	TAAGGCGA	CGATAC	TAAGGCGA
ACAGAT_TAAGGCGA	TAAGGCGA	ACAGAT	TAAGGCGA
AGTAGC_TAAGGCGA	TAAGGCGA	AGTAGC	TAAGGCGA
CGAGTG_TAAGGCGA	TAAGGCGA	CGAGTG	TAAGGCGA
GCTGAT_TAAGGCGA	TAAGGCGA	GCTGAT	TAAGGCGA
ACAGCA_TAAGGCGA	TAAGGCGA	ACAGCA	TAAGGCGA
CGAGAT_TAAGGCGA	TAAGGCGA	CGAGAT	TAAGGCGA
TATACG_TAAGGCGA	TAAGGCGA	TATACG	TAAGGCGA
GTACAG_TAAGGCGA	TAAGGCGA	GTACAG	TAAGGCGA
TATGCA_TAAGGCGA	TAAGGCGA	TATGCA	TAAGGCGA
CGAGCA_TAAGGCGA	TAAGGCGA	CGAGCA	TAAGGCGA
AGTGCA_TAAGGCGA	TAAGGCGA	AGTGCA	TAAGGCGA
GAGACG_TAAGGCGA	TAAGGCGA	GAGACG	TAAGGCGA
CTGTAC_TAAGGCGA	TAAGGCGA	CTGTAC	TAAGGCGA
GAGCAG_TAAGGCGA	TAAGGCGA	GAGCAG	TAAGGCGA
AGTCAG_TAAGGCGA	TAAGGCGA	AGTCAG	TAAGGCGA
TATGTG_TAAGGCGA	TAAGGCGA	TATGTG	TAAGGCGA
TATAGC_TAAGGCGA	TAAGGCGA	TATAGC	TAAGGCGA
GTAGCA_TAAGGCGA	TAAGGCGA	GTAGCA	TAAGGCGA
ATCGAT_TAAGGCGA	TAAGGCGA	ATCGAT	TAAGGCGA
AGTGTG_TAAGGCGA	TAAGGCGA	AGTGTG	TAAGGCGA
CGACTC_TAAGGCGA	TAAGGCGA	CGACTC	TAAGGCGA
ACACTC_TAAGGCGA	TAAGGCGA	ACACTC	TAAGGCGA
AGTGAT_TAAGGCGA	TAAGGCGA	AGTGAT	TAAGGCGA
AGTCGT_TAAGGCGA	TAAGGCGA	AGTCGT	TAAGGCGA
CTGACG_TAAGGCGA	TAAGGCGA	CTGACG	TAAGGCGA
ATCTAC_TAAGGCGA	TAAGGCGA	ATCTAC	TAAGGCGA
ACATAC_TAAGGCGA	TAAGGCGA	ACATAC	TAAGGCGA
ACACAG_TAAGGCGA	TAAGGCGA	ACACAG	TAAGGCGA
GCTAGC_TAAGGCGA	TAAGGCGA	GCTAGC	TAAGGCGA
GCTACG_TAAGGCGA	TAAGGCGA	GCTACG	TAAGGCGA
GTACTC_TAAGGCGA	TAAGGCGA	GTACTC	TAAGGCGA
GTATAC_TAAGGCGA	TAAGGCGA	GTATAC	TAAGGCGA
CTGCTC_TAAGGCGA	TAAGGCGA	CTGCTC	TAAGGCGA
ACAGTG_TAAGGCGA	TAAGGCGA	ACAGTG	TAAGGCGA
ATCACG_TAAGGCGA	TAAGGCGA	ATCACG	TAAGGCGA
CACTAC_TAAGGCGA	TAAGGCGA	CACTAC	TAAGGCGA
CACGCA_TAAGGCGA	TAAGGCGA	CACGCA	TAAGGCGA
GAGCGT_TAAGGCGA	TAAGGCGA	GAGCGT	TAAGGCGA
CGACAG_TAAGGCGA	TAAGGCGA	CGACAG	TAAGGCGA
ACACGT_TAAGGCGA	TAAGGCGA	ACACGT	TAAGGCGA
ATCTGA_TAAGGCGA	TAAGGCGA	ATCTGA	TAAGGCGA
GAGTAC_TAAGGCGA	TAAGGCGA	GAGTAC	TAAGGCGA
AGTCTC_TAAGGCGA	TAAGGCGA	AGTCTC	TAAGGCGA
GAGTCT_TAAGGCGA	TAAGGCGA	GAGTCT	TAAGGCGA
CGACGT_TAAGGCGA	TAAGGCGA	CGACGT	TAAGGCGA
CACAGC_TAAGGCGA	TAAGGCGA	CACAGC	TAAGGCGA
ATCGCA_TAAGGCGA	TAAGGCGA	ATCGCA	TAAGGCGA
CTGCAG_TAAGGCGA	TAAGGCGA	CTGCAG	TAAGGCGA
GAGTGA_TAAGGCGA	TAAGGCGA	GAGTGA	TAAGGCGA
CACATA_TAAGGCGA	TAAGGCGA	CACATA	TAAGGCGA
AGTACG_TAAGGCGA	TAAGGCGA	AGTACG	TAAGGCGA
GTACGT_TAAGGCGA	TAAGGCGA	GTACGT	TAAGGCGA
ATCTCT_TAAGGCGA	TAAGGCGA	ATCTCT	TAAGGCGA
CACACG_TAAGGCGA	TAAGGCGA	CACACG	TAAGGCGA
CACTCT_TAAGGCGA	TAAGGCGA	CACTCT	TAAGGCGA
CTGAGC_TAAGGCGA	TAAGGCGA	CTGAGC	TAAGGCGA
GTAGTG_TAAGGCGA	TAAGGCGA	GTAGTG	TAAGGCGA
CACGAT_TAAGGCGA	TAAGGCGA	CACGAT	TAAGGCGA
GCTATA_TAAGGCGA	TAAGGCGA	GCTATA	TAAGGCGA
GTAGAT_TAAGGCGA	TAAGGCGA	GTAGAT	TAAGGCGA
GCTCAG_TAAGGCGA	TAAGGCGA	GCTCAG	TAAGGCGA
TATACG_CGTACTAG	CGTACTAG	TATACG	CGTACTAG
GCTAGC_CGTACTAG	CGTACTAG	GCTAGC	CGTACTAG
CACTAC_CGTACTAG	CGTACTAG	CACTAC	CGTACTAG
GTACAG_CGTACTAG	CGTACTAG	GTACAG	CGTACTAG
CACGCA_CGTACTAG	CGTACTAG	CACGCA	CGTACTAG
CGAGCA_CGTACTAG	CGTACTAG	CGAGCA	CGTACTAG
CACTCT_CGTACTAG	CGTACTAG	CACTCT	CGTACTAG
GTAGTG_CGTACTAG	CGTACTAG	GTAGTG	CGTACTAG
CTGAGC_CGTACTAG	CGTACTAG	CTGAGC	CGTACTAG
GCTGCA_CGTACTAG	CGTACTAG	GCTGCA	CGTACTAG
ATCTAC_CGTACTAG	CGTACTAG	ATCTAC	CGTACTAG
CTGTAC_CGTACTAG	CGTACTAG	CTGTAC	CGTACTAG
GTACTC_CGTACTAG	CGTACTAG	GTACTC	CGTACTAG
AGTCGT_CGTACTAG	CGTACTAG	AGTCGT	CGTACTAG
CACGAT_CGTACTAG	CGTACTAG	CACGAT	CGTACTAG
CACACG_CGTACTAG	CGTACTAG	CACACG	CGTACTAG
GTAGCA_CGTACTAG	CGTACTAG	GTAGCA	CGTACTAG
ATCACG_CGTACTAG	CGTACTAG	ATCACG	CGTACTAG
GCTATA_CGTACTAG	CGTACTAG	GCTATA	CGTACTAG
ACACTC_CGTACTAG	CGTACTAG	ACACTC	CGTACTAG
GTAGAT_CGTACTAG	CGTACTAG	GTAGAT	CGTACTAG
CTGCAG_CGTACTAG	CGTACTAG	CTGCAG	CGTACTAG
CTGCGT_CGTACTAG	CGTACTAG	CTGCGT	CGTACTAG
ACAGTG_CGTACTAG	CGTACTAG	ACAGTG	CGTACTAG
ACACGT_CGTACTAG	CGTACTAG	ACACGT	CGTACTAG
ATCTCT_CGTACTAG	CGTACTAG	ATCTCT	CGTACTAG
AGTGCA_CGTACTAG	CGTACTAG	AGTGCA	CGTACTAG
TATGCA_CGTACTAG	CGTACTAG	TATGCA	CGTACTAG
TATGTG_CGTACTAG	CGTACTAG	TATGTG	CGTACTAG
GAGCGT_CGTACTAG	CGTACTAG	GAGCGT	CGTACTAG
ATCGCA_CGTACTAG	CGTACTAG	ATCGCA	CGTACTAG
CGACTC_CGTACTAG	CGTACTAG	CGACTC	CGTACTAG
ACACAG_CGTACTAG	CGTACTAG	ACACAG	CGTACTAG
AGTAGC_CGTACTAG	CGTACTAG	AGTAGC	CGTACTAG
ATCGAT_CGTACTAG	CGTACTAG	ATCGAT	CGTACTAG
GAGCAG_CGTACTAG	CGTACTAG	GAGCAG	CGTACTAG
GAGTGA_CGTACTAG	CGTACTAG	GAGTGA	CGTACTAG
CGACGT_CGTACTAG	CGTACTAG	CGACGT	CGTACTAG
CGATAC_CGTACTAG	CGTACTAG	CGATAC	CGTACTAG
AGTCTC_CGTACTAG	CGTACTAG	AGTCTC	CGTACTAG
AGTACG_CGTACTAG	CGTACTAG	AGTACG	CGTACTAG
CGAGAT_CGTACTAG	CGTACTAG	CGAGAT	CGTACTAG
CGAGTG_CGTACTAG	CGTACTAG	CGAGTG	CGTACTAG
GAGTCT_CGTACTAG	CGTACTAG	GAGTCT	CGTACTAG
TATAGC_CGTACTAG	CGTACTAG	TATAGC	CGTACTAG
CACATA_CGTACTAG	CGTACTAG	CACATA	CGTACTAG
ACATAC_CGTACTAG	CGTACTAG	ACATAC	CGTACTAG
GCTACG_CGTACTAG	CGTACTAG	GCTACG	CGTACTAG
ACAGCA_CGTACTAG	CGTACTAG	ACAGCA	CGTACTAG
GAGACG_CGTACTAG	CGTACTAG	GAGACG	CGTACTAG
GCTCAG_CGTACTAG	CGTACTAG	GCTCAG	CGTACTAG
ACAGAT_CGTACTAG	CGTACTAG	ACAGAT	CGTACTAG
CGACAG_CGTACTAG	CGTACTAG	CGACAG	CGTACTAG
CTGACG_CGTACTAG	CGTACTAG	CTGACG	CGTACTAG
AGTGAT_CGTACTAG	CGTACTAG	AGTGAT	CGTACTAG
GCTGAT_CGTACTAG	CGTACTAG	GCTGAT	CGTACTAG
GAGTAC_CGTACTAG	CGTACTAG	GAGTAC	CGTACTAG
CACAGC_CGTACTAG	CGTACTAG	CACAGC	CGTACTAG
AGTCAG_CGTACTAG	CGTACTAG	AGTCAG	CGTACTAG
GTACGT_CGTACTAG	CGTACTAG	GTACGT	CGTACTAG
ATCTGA_CGTACTAG	CGTACTAG	ATCTGA	CGTACTAG
GTATAC_CGTACTAG	CGTACTAG	GTATAC	CGTACTAG
CTGCTC_CGTACTAG	CGTACTAG	CTGCTC	CGTACTAG
AGTGTG_CGTACTAG	CGTACTAG	AGTGTG	CGTACTAG
AGTGAT_AGGCAGAA	AGGCAGAA	AGTGAT	AGGCAGAA
ATCTGA_AGGCAGAA	AGGCAGAA	ATCTGA	AGGCAGAA
AGTCGT_AGGCAGAA	AGGCAGAA	AGTCGT	AGGCAGAA
CGAGCA_AGGCAGAA	AGGCAGAA	CGAGCA	AGGCAGAA
CACAGC_AGGCAGAA	AGGCAGAA	CACAGC	AGGCAGAA
ACAGTG_AGGCAGAA	AGGCAGAA	ACAGTG	AGGCAGAA
ACAGCA_AGGCAGAA	AGGCAGAA	ACAGCA	AGGCAGAA
GTAGCA_AGGCAGAA	AGGCAGAA	GTAGCA	AGGCAGAA
GTACTC_AGGCAGAA	AGGCAGAA	GTACTC	AGGCAGAA
CTGCAG_AGGCAGAA	AGGCAGAA	CTGCAG	AGGCAGAA
CTGTAC_AGGCAGAA	AGGCAGAA	CTGTAC	AGGCAGAA
CACATA_AGGCAGAA	AGGCAGAA	CACATA	AGGCAGAA
AGTAGC_AGGCAGAA	AGGCAGAA	AGTAGC	AGGCAGAA
CGAGTG_AGGCAGAA	AGGCAGAA	CGAGTG	AGGCAGAA
CACTCT_AGGCAGAA	AGGCAGAA	CACTCT	AGGCAGAA
CTGAGC_AGGCAGAA	AGGCAGAA	CTGAGC	AGGCAGAA
CGACAG_AGGCAGAA	AGGCAGAA	CGACAG	AGGCAGAA
GAGCAG_AGGCAGAA	AGGCAGAA	GAGCAG	AGGCAGAA
GAGACG_AGGCAGAA	AGGCAGAA	GAGACG	AGGCAGAA
GCTATA_AGGCAGAA	AGGCAGAA	GCTATA	AGGCAGAA
AGTGTG_AGGCAGAA	AGGCAGAA	AGTGTG	AGGCAGAA
AGTGCA_AGGCAGAA	AGGCAGAA	AGTGCA	AGGCAGAA
ATCTCT_AGGCAGAA	AGGCAGAA	ATCTCT	AGGCAGAA
ACAGAT_AGGCAGAA	AGGCAGAA	ACAGAT	AGGCAGAA
GAGTAC_AGGCAGAA	AGGCAGAA	GAGTAC	AGGCAGAA
ACACTC_AGGCAGAA	AGGCAGAA	ACACTC	AGGCAGAA
GCTACG_AGGCAGAA	AGGCAGAA	GCTACG	AGGCAGAA
CTGCTC_AGGCAGAA	AGGCAGAA	CTGCTC	AGGCAGAA
TATACG_AGGCAGAA	AGGCAGAA	TATACG	AGGCAGAA
GTAGTG_AGGCAGAA	AGGCAGAA	GTAGTG	AGGCAGAA
GCTGAT_AGGCAGAA	AGGCAGAA	GCTGAT	AGGCAGAA
AGTACG_AGGCAGAA	AGGCAGAA	AGTACG	AGGCAGAA
CACGAT_AGGCAGAA	AGGCAGAA	CACGAT	AGGCAGAA
ATCGCA_AGGCAGAA	AGGCAGAA	ATCGCA	AGGCAGAA
AGTCAG_AGGCAGAA	AGGCAGAA	AGTCAG	AGGCAGAA
GCTGCA_AGGCAGAA	AGGCAGAA	GCTGCA	AGGCAGAA
ACATAC_AGGCAGAA	AGGCAGAA	ACATAC	AGGCAGAA
CGACGT_AGGCAGAA	AGGCAGAA	CGACGT	AGGCAGAA
CTGCGT_AGGCAGAA	AGGCAGAA	CTGCGT	AGGCAGAA
GAGCGT_AGGCAGAA	AGGCAGAA	GAGCGT	AGGCAGAA
TATGTG_AGGCAGAA	AGGCAGAA	TATGTG	AGGCAGAA
GCTCGT_AGGCAGAA	AGGCAGAA	GCTCGT	AGGCAGAA
CGACTC_AGGCAGAA	AGGCAGAA	CGACTC	AGGCAGAA
TATAGC_AGGCAGAA	AGGCAGAA	TATAGC	AGGCAGAA
ACACAG_AGGCAGAA	AGGCAGAA	ACACAG	AGGCAGAA
GTACAG_AGGCAGAA	AGGCAGAA	GTACAG	AGGCAGAA
CACTAC_AGGCAGAA	AGGCAGAA	CACTAC	AGGCAGAA
CGAGAT_AGGCAGAA	AGGCAGAA	CGAGAT	AGGCAGAA
GCTCAG_AGGCAGAA	AGGCAGAA	GCTCAG	AGGCAGAA
ATCACG_AGGCAGAA	AGGCAGAA	ATCACG	AGGCAGAA
CTGACG_AGGCAGAA	AGGCAGAA	CTGACG	AGGCAGAA
CACACG_AGGCAGAA	AGGCAGAA	CACACG	AGGCAGAA
GCTAGC_AGGCAGAA	AGGCAGAA	GCTAGC	AGGCAGAA
GAGTCT_AGGCAGAA	AGGCAGAA	GAGTCT	AGGCAGAA
ATCTAC_AGGCAGAA	AGGCAGAA	ATCTAC	AGGCAGAA
TATGCA_AGGCAGAA	AGGCAGAA	TATGCA	AGGCAGAA
AGTCTC_AGGCAGAA	AGGCAGAA	AGTCTC	AGGCAGAA
GTACGT_AGGCAGAA	AGGCAGAA	GTACGT	AGGCAGAA
ACACGT_AGGCAGAA	AGGCAGAA	ACACGT	AGGCAGAA
GTATAC_AGGCAGAA	AGGCAGAA	GTATAC	AGGCAGAA
GTAGAT_AGGCAGAA	AGGCAGAA	GTAGAT	AGGCAGAA
CGATAC_AGGCAGAA	AGGCAGAA	CGATAC	AGGCAGAA
ATCGAT_AGGCAGAA	AGGCAGAA	ATCGAT	AGGCAGAA
GAGTGA_AGGCAGAA	AGGCAGAA	GAGTGA	AGGCAGAA
CTGAGC_TCCTGAGC	TCCTGAGC	CTGAGC	TCCTGAGC
AGTCTC_TCCTGAGC	TCCTGAGC	AGTCTC	TCCTGAGC
CGAGCA_TCCTGAGC	TCCTGAGC	CGAGCA	TCCTGAGC
CACGAT_TCCTGAGC	TCCTGAGC	CACGAT	TCCTGAGC
ACACGT_TCCTGAGC	TCCTGAGC	ACACGT	TCCTGAGC
CACTCT_TCCTGAGC	TCCTGAGC	CACTCT	TCCTGAGC
AGTAGC_TCCTGAGC	TCCTGAGC	AGTAGC	TCCTGAGC
GTACAG_TCCTGAGC	TCCTGAGC	GTACAG	TCCTGAGC
CTGCAG_TCCTGAGC	TCCTGAGC	CTGCAG	TCCTGAGC
CTGTAC_TCCTGAGC	TCCTGAGC	CTGTAC	TCCTGAGC
TATGCA_TCCTGAGC	TCCTGAGC	TATGCA	TCCTGAGC
GTAGCA_TCCTGAGC	TCCTGAGC	GTAGCA	TCCTGAGC
GCTGAT_TCCTGAGC	TCCTGAGC	GCTGAT	TCCTGAGC
ACACAG_TCCTGAGC	TCCTGAGC	ACACAG	TCCTGAGC
CTGCTC_TCCTGAGC	TCCTGAGC	CTGCTC	TCCTGAGC
ATCACG_TCCTGAGC	TCCTGAGC	ATCACG	TCCTGAGC
GAGTGA_TCCTGAGC	TCCTGAGC	GAGTGA	TCCTGAGC
AGTGTG_TCCTGAGC	TCCTGAGC	AGTGTG	TCCTGAGC
ACAGAT_TCCTGAGC	TCCTGAGC	ACAGAT	TCCTGAGC
TCGAGC_TCCTGAGC	TCCTGAGC	TCGAGC	TCCTGAGC
GCTGCA_TCCTGAGC	TCCTGAGC	GCTGCA	TCCTGAGC
GTACGT_TCCTGAGC	TCCTGAGC	GTACGT	TCCTGAGC
CTGACG_TCCTGAGC	TCCTGAGC	CTGACG	TCCTGAGC
CGATAC_TCCTGAGC	TCCTGAGC	CGATAC	TCCTGAGC
CGACGT_TCCTGAGC	TCCTGAGC	CGACGT	TCCTGAGC
ACACTC_TCCTGAGC	TCCTGAGC	ACACTC	TCCTGAGC
ACAGTG_TCCTGAGC	TCCTGAGC	ACAGTG	TCCTGAGC
CACAGC_TCCTGAGC	TCCTGAGC	CACAGC	TCCTGAGC
GAGACG_TCCTGAGC	TCCTGAGC	GAGACG	TCCTGAGC
ATCTCT_TCCTGAGC	TCCTGAGC	ATCTCT	TCCTGAGC
CACTAC_TCCTGAGC	TCCTGAGC	CACTAC	TCCTGAGC
CGAGAT_TCCTGAGC	TCCTGAGC	CGAGAT	TCCTGAGC
CACATA_TCCTGAGC	TCCTGAGC	CACATA	TCCTGAGC
GCTAGC_TCCTGAGC	TCCTGAGC	GCTAGC	TCCTGAGC
GTATAC_TCCTGAGC	TCCTGAGC	GTATAC	TCCTGAGC
GAGTAC_TCCTGAGC	TCCTGAGC	GAGTAC	TCCTGAGC
ATCTAC_TCCTGAGC	TCCTGAGC	ATCTAC	TCCTGAGC
TATACG_TCCTGAGC	TCCTGAGC	TATACG	TCCTGAGC
AGTCGT_TCCTGAGC	TCCTGAGC	AGTCGT	TCCTGAGC
ACAGCA_TCCTGAGC	TCCTGAGC	ACAGCA	TCCTGAGC
GCTACG_TCCTGAGC	TCCTGAGC	GCTACG	TCCTGAGC
AGTGCA_TCCTGAGC	TCCTGAGC	AGTGCA	TCCTGAGC
GCTCAG_TCCTGAGC	TCCTGAGC	GCTCAG	TCCTGAGC
AGTCAG_TCCTGAGC	TCCTGAGC	AGTCAG	TCCTGAGC
GAGCGT_TCCTGAGC	TCCTGAGC	GAGCGT	TCCTGAGC
GTAGTG_TCCTGAGC	TCCTGAGC	GTAGTG	TCCTGAGC
CGAGTG_TCCTGAGC	TCCTGAGC	CGAGTG	TCCTGAGC
ATCGAT_TCCTGAGC	TCCTGAGC	ATCGAT	TCCTGAGC
ATCTGA_TCCTGAGC	TCCTGAGC	ATCTGA	TCCTGAGC
CGACAG_TCCTGAGC	TCCTGAGC	CGACAG	TCCTGAGC
CGACTC_TCCTGAGC	TCCTGAGC	CGACTC	TCCTGAGC
ACATAC_TCCTGAGC	TCCTGAGC	ACATAC	TCCTGAGC
GAGTCT_TCCTGAGC	TCCTGAGC	GAGTCT	TCCTGAGC
AGTACG_TCCTGAGC	TCCTGAGC	AGTACG	TCCTGAGC
GTAGAT_TCCTGAGC	TCCTGAGC	GTAGAT	TCCTGAGC
GCTATA_TCCTGAGC	TCCTGAGC	GCTATA	TCCTGAGC
GAGCAG_TCCTGAGC	TCCTGAGC	GAGCAG	TCCTGAGC
GTACTC_TCCTGAGC	TCCTGAGC	GTACTC	TCCTGAGC
ATCGCA_TCCTGAGC	TCCTGAGC	ATCGCA	TCCTGAGC
AGTGAT_TCCTGAGC	TCCTGAGC	AGTGAT	TCCTGAGC
CACACG_TCCTGAGC	TCCTGAGC	CACACG	TCCTGAGC
TATAGC_TCCTGAGC	TCCTGAGC	TATAGC	TCCTGAGC
CTGCGT_TCCTGAGC	TCCTGAGC	CTGCGT	TCCTGAGC
TATGTG_TCCTGAGC	TCCTGAGC	TATGTG	TCCTGAGC
CACATA_GGACTCCT	GGACTCCT	CACATA	GGACTCCT
GTATAC_GGACTCCT	GGACTCCT	GTATAC	GGACTCCT
ACAGTG_GGACTCCT	GGACTCCT	ACAGTG	GGACTCCT
AGTGAT_GGACTCCT	GGACTCCT	AGTGAT	GGACTCCT
ATCTGA_GGACTCCT	GGACTCCT	ATCTGA	GGACTCCT
GCTACG_GGACTCCT	GGACTCCT	GCTACG	GGACTCCT
GTACGT_GGACTCCT	GGACTCCT	GTACGT	GGACTCCT
TATACG_GGACTCCT	GGACTCCT	TATACG	GGACTCCT
ACATAC_GGACTCCT	GGACTCCT	ACATAC	GGACTCCT
ATCTAC_GGACTCCT	GGACTCCT	ATCTAC	GGACTCCT
CTGACG_GGACTCCT	GGACTCCT	CTGACG	GGACTCCT
ATCTCT_GGACTCCT	GGACTCCT	ATCTCT	GGACTCCT
CTGTAC_GGACTCCT	GGACTCCT	CTGTAC	GGACTCCT
CGACGT_GGACTCCT	GGACTCCT	CGACGT	GGACTCCT
GCTAGC_GGACTCCT	GGACTCCT	GCTAGC	GGACTCCT
AGTCTC_GGACTCCT	GGACTCCT	AGTCTC	GGACTCCT
GTAGTG_GGACTCCT	GGACTCCT	GTAGTG	GGACTCCT
ACACGT_GGACTCCT	GGACTCCT	ACACGT	GGACTCCT
CTGCAG_GGACTCCT	GGACTCCT	CTGCAG	GGACTCCT
GAGTCT_GGACTCCT	GGACTCCT	GAGTCT	GGACTCCT
GAGTAC_GGACTCCT	GGACTCCT	GAGTAC	GGACTCCT
ACAGCA_GGACTCCT	GGACTCCT	ACAGCA	GGACTCCT
CTGCTC_GGACTCCT	GGACTCCT	CTGCTC	GGACTCCT
CACTAC_GGACTCCT	GGACTCCT	CACTAC	GGACTCCT
AGTCAG_GGACTCCT	GGACTCCT	AGTCAG	GGACTCCT
AGTGCA_GGACTCCT	GGACTCCT	AGTGCA	GGACTCCT
ATCGAT_GGACTCCT	GGACTCCT	ATCGAT	GGACTCCT
GCTATA_GGACTCCT	GGACTCCT	GCTATA	GGACTCCT
ATCACG_GGACTCCT	GGACTCCT	ATCACG	GGACTCCT
CTGCGT_GGACTCCT	GGACTCCT	CTGCGT	GGACTCCT
CACAGC_GGACTCCT	GGACTCCT	CACAGC	GGACTCCT
AGTACG_GGACTCCT	GGACTCCT	AGTACG	GGACTCCT
TATGCA_GGACTCCT	GGACTCCT	TATGCA	GGACTCCT
CGACTC_GGACTCCT	GGACTCCT	CGACTC	GGACTCCT
CACGAT_GGACTCCT	GGACTCCT	CACGAT	GGACTCCT
CTGAGC_GGACTCCT	GGACTCCT	CTGAGC	GGACTCCT
GCTGCA_GGACTCCT	GGACTCCT	GCTGCA	GGACTCCT
ACAGAT_GGACTCCT	GGACTCCT	ACAGAT	GGACTCCT
GAGACG_GGACTCCT	GGACTCCT	GAGACG	GGACTCCT
GTAGCA_GGACTCCT	GGACTCCT	GTAGCA	GGACTCCT
CGACAG_GGACTCCT	GGACTCCT	CGACAG	GGACTCCT
ATCGCA_GGACTCCT	GGACTCCT	ATCGCA	GGACTCCT
AGTCGT_GGACTCCT	GGACTCCT	AGTCGT	GGACTCCT
AGTAGC_GGACTCCT	GGACTCCT	AGTAGC	GGACTCCT
GAGCAG_GGACTCCT	GGACTCCT	GAGCAG	GGACTCCT
GTAGAT_GGACTCCT	GGACTCCT	GTAGAT	GGACTCCT
GAGCGT_GGACTCCT	GGACTCCT	GAGCGT	GGACTCCT
AGTGTG_GGACTCCT	GGACTCCT	AGTGTG	GGACTCCT
TATGTG_GGACTCCT	GGACTCCT	TATGTG	GGACTCCT
TATAGC_GGACTCCT	GGACTCCT	TATAGC	GGACTCCT
ACACAG_GGACTCCT	GGACTCCT	ACACAG	GGACTCCT
CACTCT_GGACTCCT	GGACTCCT	CACTCT	GGACTCCT
CGATAC_GGACTCCT	GGACTCCT	CGATAC	GGACTCCT
GTACAG_GGACTCCT	GGACTCCT	GTACAG	GGACTCCT
GCTGAT_GGACTCCT	GGACTCCT	GCTGAT	GGACTCCT
CGATCT_GGACTCCT	GGACTCCT	CGATCT	GGACTCCT
GTACTC_GGACTCCT	GGACTCCT	GTACTC	GGACTCCT
CGAGTG_GGACTCCT	GGACTCCT	CGAGTG	GGACTCCT
CACACG_GGACTCCT	GGACTCCT	CACACG	GGACTCCT
CGAGCA_GGACTCCT	GGACTCCT	CGAGCA	GGACTCCT
ACACTC_GGACTCCT	GGACTCCT	ACACTC	GGACTCCT
GCTCAG_GGACTCCT	GGACTCCT	GCTCAG	GGACTCCT
CGAGAT_GGACTCCT	GGACTCCT	CGAGAT	GGACTCCT
GAGTGA_GGACTCCT	GGACTCCT	GAGTGA	GGACTCCT
CGACGT_TAGGCATG	TAGGCATG	CGACGT	TAGGCATG
TATACG_TAGGCATG	TAGGCATG	TATACG	TAGGCATG
ACATAC_TAGGCATG	TAGGCATG	ACATAC	TAGGCATG
GAGTCT_TAGGCATG	TAGGCATG	GAGTCT	TAGGCATG
GTAGTG_TAGGCATG	TAGGCATG	GTAGTG	TAGGCATG
CGAGAT_TAGGCATG	TAGGCATG	CGAGAT	TAGGCATG
ACAGCA_TAGGCATG	TAGGCATG	ACAGCA	TAGGCATG
AGTGCA_TAGGCATG	TAGGCATG	AGTGCA	TAGGCATG
ACACTC_TAGGCATG	TAGGCATG	ACACTC	TAGGCATG
CGAGCA_TAGGCATG	TAGGCATG	CGAGCA	TAGGCATG
CTGCGT_TAGGCATG	TAGGCATG	CTGCGT	TAGGCATG
AGTCAG_TAGGCATG	TAGGCATG	AGTCAG	TAGGCATG
GTACTC_TAGGCATG	TAGGCATG	GTACTC	TAGGCATG
GCTGAT_TAGGCATG	TAGGCATG	GCTGAT	TAGGCATG
CACGAT_TAGGCATG	TAGGCATG	CACGAT	TAGGCATG
ACACAG_TAGGCATG	TAGGCATG	ACACAG	TAGGCATG
GAGCGT_TAGGCATG	TAGGCATG	GAGCGT	TAGGCATG
GAGTAC_TAGGCATG	TAGGCATG	GAGTAC	TAGGCATG
GCTCGT_TAGGCATG	TAGGCATG	GCTCGT	TAGGCATG
GTACGT_TAGGCATG	TAGGCATG	GTACGT	TAGGCATG
CACTCT_TAGGCATG	TAGGCATG	CACTCT	TAGGCATG
CGATAC_TAGGCATG	TAGGCATG	CGATAC	TAGGCATG
CTGACG_TAGGCATG	TAGGCATG	CTGACG	TAGGCATG
GCTACG_TAGGCATG	TAGGCATG	GCTACG	TAGGCATG
ATCTGA_TAGGCATG	TAGGCATG	ATCTGA	TAGGCATG
CTGAGC_TAGGCATG	TAGGCATG	CTGAGC	TAGGCATG
ATCTAC_TAGGCATG	TAGGCATG	ATCTAC	TAGGCATG
CTGCTC_TAGGCATG	TAGGCATG	CTGCTC	TAGGCATG
ACAGAT_TAGGCATG	TAGGCATG	ACAGAT	TAGGCATG
AGTGTG_TAGGCATG	TAGGCATG	AGTGTG	TAGGCATG
GTACAG_TAGGCATG	TAGGCATG	GTACAG	TAGGCATG
GAGCAG_TAGGCATG	TAGGCATG	GAGCAG	TAGGCATG
CACACG_TAGGCATG	TAGGCATG	CACACG	TAGGCATG
ATCTCT_TAGGCATG	TAGGCATG	ATCTCT	TAGGCATG
GCTCAG_TAGGCATG	TAGGCATG	GCTCAG	TAGGCATG
GAGACG_TAGGCATG	TAGGCATG	GAGACG	TAGGCATG
GCTAGC_TAGGCATG	TAGGCATG	GCTAGC	TAGGCATG
CACAGC_TAGGCATG	TAGGCATG	CACAGC	TAGGCATG
AGTAGC_TAGGCATG	TAGGCATG	AGTAGC	TAGGCATG
CTGTAC_TAGGCATG	TAGGCATG	CTGTAC	TAGGCATG
ACAGTG_TAGGCATG	TAGGCATG	ACAGTG	TAGGCATG
ATCGAT_TAGGCATG	TAGGCATG	ATCGAT	TAGGCATG
AGTACG_TAGGCATG	TAGGCATG	AGTACG	TAGGCATG
ACACGT_TAGGCATG	TAGGCATG	ACACGT	TAGGCATG
AGTCGT_TAGGCATG	TAGGCATG	AGTCGT	TAGGCATG
ATCGCA_TAGGCATG	TAGGCATG	ATCGCA	TAGGCATG
CGAGTG_TAGGCATG	TAGGCATG	CGAGTG	TAGGCATG
GTATAC_TAGGCATG	TAGGCATG	GTATAC	TAGGCATG
TATGCA_TAGGCATG	TAGGCATG	TATGCA	TAGGCATG
GTAGAT_TAGGCATG	TAGGCATG	GTAGAT	TAGGCATG
CTGCAG_TAGGCATG	TAGGCATG	CTGCAG	TAGGCATG
AGTCTC_TAGGCATG	TAGGCATG	AGTCTC	TAGGCATG
TATAGC_TAGGCATG	TAGGCATG	TATAGC	TAGGCATG
GCTGCA_TAGGCATG	TAGGCATG	GCTGCA	TAGGCATG
ATCACG_TAGGCATG	TAGGCATG	ATCACG	TAGGCATG
CGACAG_TAGGCATG	TAGGCATG	CGACAG	TAGGCATG
CACTAC_TAGGCATG	TAGGCATG	CACTAC	TAGGCATG
GCTATA_TAGGCATG	TAGGCATG	GCTATA	TAGGCATG
TATGTG_TAGGCATG	TAGGCATG	TATGTG	TAGGCATG
AGTGAT_TAGGCATG	TAGGCATG	AGTGAT	TAGGCATG
CACATA_TAGGCATG	TAGGCATG	CACATA	TAGGCATG
CGACTC_TAGGCATG	TAGGCATG	CGACTC	TAGGCATG
GAGTGA_TAGGCATG	TAGGCATG	GAGTGA	TAGGCATG
GTAGCA_TAGGCATG	TAGGCATG	GTAGCA	TAGGCATG
TATGTG_CTCTCTAC	CTCTCTAC	TATGTG	CTCTCTAC
GAGTAC_CTCTCTAC	CTCTCTAC	GAGTAC	CTCTCTAC
GTACAG_CTCTCTAC	CTCTCTAC	GTACAG	CTCTCTAC
GTACGT_CTCTCTAC	CTCTCTAC	GTACGT	CTCTCTAC
GCTGCA_CTCTCTAC	CTCTCTAC	GCTGCA	CTCTCTAC
TATAGC_CTCTCTAC	CTCTCTAC	TATAGC	CTCTCTAC
GAGTGA_CTCTCTAC	CTCTCTAC	GAGTGA	CTCTCTAC
ACACTC_CTCTCTAC	CTCTCTAC	ACACTC	CTCTCTAC
CTGACG_CTCTCTAC	CTCTCTAC	CTGACG	CTCTCTAC
TATACG_CTCTCTAC	CTCTCTAC	TATACG	CTCTCTAC
GCTGAT_CTCTCTAC	CTCTCTAC	GCTGAT	CTCTCTAC
CGATAC_CTCTCTAC	CTCTCTAC	CGATAC	CTCTCTAC
CACTAC_CTCTCTAC	CTCTCTAC	CACTAC	CTCTCTAC
CGAGTG_CTCTCTAC	CTCTCTAC	CGAGTG	CTCTCTAC
ATCGAT_CTCTCTAC	CTCTCTAC	ATCGAT	CTCTCTAC
CTGTAC_CTCTCTAC	CTCTCTAC	CTGTAC	CTCTCTAC
CTGCTC_CTCTCTAC	CTCTCTAC	CTGCTC	CTCTCTAC
GAGTCT_CTCTCTAC	CTCTCTAC	GAGTCT	CTCTCTAC
AGTAGC_CTCTCTAC	CTCTCTAC	AGTAGC	CTCTCTAC
AGTACG_CTCTCTAC	CTCTCTAC	AGTACG	CTCTCTAC
GTACTC_CTCTCTAC	CTCTCTAC	GTACTC	CTCTCTAC
ACATAC_CTCTCTAC	CTCTCTAC	ACATAC	CTCTCTAC
GCTATA_CTCTCTAC	CTCTCTAC	GCTATA	CTCTCTAC
AGTGCA_CTCTCTAC	CTCTCTAC	AGTGCA	CTCTCTAC
AGTCAG_CTCTCTAC	CTCTCTAC	AGTCAG	CTCTCTAC
CGACAG_CTCTCTAC	CTCTCTAC	CGACAG	CTCTCTAC
CGACGT_CTCTCTAC	CTCTCTAC	CGACGT	CTCTCTAC
GTAGCA_CTCTCTAC	CTCTCTAC	GTAGCA	CTCTCTAC
ATCACG_CTCTCTAC	CTCTCTAC	ATCACG	CTCTCTAC
CTGAGC_CTCTCTAC	CTCTCTAC	CTGAGC	CTCTCTAC
CGAGCA_CTCTCTAC	CTCTCTAC	CGAGCA	CTCTCTAC
AGTCTC_CTCTCTAC	CTCTCTAC	AGTCTC	CTCTCTAC
ATCTCT_CTCTCTAC	CTCTCTAC	ATCTCT	CTCTCTAC
GTAGAT_CTCTCTAC	CTCTCTAC	GTAGAT	CTCTCTAC
GTAGTG_CTCTCTAC	CTCTCTAC	GTAGTG	CTCTCTAC
GAGCGT_CTCTCTAC	CTCTCTAC	GAGCGT	CTCTCTAC
ATCGCA_CTCTCTAC	CTCTCTAC	ATCGCA	CTCTCTAC
ATCTGA_CTCTCTAC	CTCTCTAC	ATCTGA	CTCTCTAC
GTATAC_CTCTCTAC	CTCTCTAC	GTATAC	CTCTCTAC
GCTAGC_CTCTCTAC	CTCTCTAC	GCTAGC	CTCTCTAC
GCTCAG_CTCTCTAC	CTCTCTAC	GCTCAG	CTCTCTAC
CACATA_CTCTCTAC	CTCTCTAC	CACATA	CTCTCTAC
CTGCAG_CTCTCTAC	CTCTCTAC	CTGCAG	CTCTCTAC
CACAGC_CTCTCTAC	CTCTCTAC	CACAGC	CTCTCTAC
ACACAG_CTCTCTAC	CTCTCTAC	ACACAG	CTCTCTAC
AGTCGT_CTCTCTAC	CTCTCTAC	AGTCGT	CTCTCTAC
CGACTC_CTCTCTAC	CTCTCTAC	CGACTC	CTCTCTAC
ACAGCA_CTCTCTAC	CTCTCTAC	ACAGCA	CTCTCTAC
TATGCA_CTCTCTAC	CTCTCTAC	TATGCA	CTCTCTAC
CGAGAT_CTCTCTAC	CTCTCTAC	CGAGAT	CTCTCTAC
GAGACG_CTCTCTAC	CTCTCTAC	GAGACG	CTCTCTAC
ATCAGC_CTCTCTAC	CTCTCTAC	ATCAGC	CTCTCTAC
GCTACG_CTCTCTAC	CTCTCTAC	GCTACG	CTCTCTAC
ACAGTG_CTCTCTAC	CTCTCTAC	ACAGTG	CTCTCTAC
AGTGAT_CTCTCTAC	CTCTCTAC	AGTGAT	CTCTCTAC
ACACGT_CTCTCTAC	CTCTCTAC	ACACGT	CTCTCTAC
AGTGTG_CTCTCTAC	CTCTCTAC	AGTGTG	CTCTCTAC
CACGAT_CTCTCTAC	CTCTCTAC	CACGAT	CTCTCTAC
CACACG_CTCTCTAC	CTCTCTAC	CACACG	CTCTCTAC
CACTCT_CTCTCTAC	CTCTCTAC	CACTCT	CTCTCTAC
GAGCAG_CTCTCTAC	CTCTCTAC	GAGCAG	CTCTCTAC
ACAGAT_CTCTCTAC	CTCTCTAC	ACAGAT	CTCTCTAC
ATCTAC_CTCTCTAC	CTCTCTAC	ATCTAC	CTCTCTAC
CTGCGT_CTCTCTAC	CTCTCTAC	CTGCGT	CTCTCTAC
TATGCA_CGAGGCTG	CGAGGCTG	TATGCA	CGAGGCTG
ATCTGA_CGAGGCTG	CGAGGCTG	ATCTGA	CGAGGCTG
GCTCAG_CGAGGCTG	CGAGGCTG	GCTCAG	CGAGGCTG
AGTCTC_CGAGGCTG	CGAGGCTG	AGTCTC	CGAGGCTG
GAGCGT_CGAGGCTG	CGAGGCTG	GAGCGT	CGAGGCTG
CACGCA_CGAGGCTG	CGAGGCTG	CACGCA	CGAGGCTG
ATCGAT_CGAGGCTG	CGAGGCTG	ATCGAT	CGAGGCTG
CACTAC_CGAGGCTG	CGAGGCTG	CACTAC	CGAGGCTG
GCTACG_CGAGGCTG	CGAGGCTG	GCTACG	CGAGGCTG
GAGTAC_CGAGGCTG	CGAGGCTG	GAGTAC	CGAGGCTG
AGTCGT_CGAGGCTG	CGAGGCTG	AGTCGT	CGAGGCTG
CGAGTG_CGAGGCTG	CGAGGCTG	CGAGTG	CGAGGCTG
CTGAGC_CGAGGCTG	CGAGGCTG	CTGAGC	CGAGGCTG
CGATAC_CGAGGCTG	CGAGGCTG	CGATAC	CGAGGCTG
GTAGTG_CGAGGCTG	CGAGGCTG	GTAGTG	CGAGGCTG
ACAGCA_CGAGGCTG	CGAGGCTG	ACAGCA	CGAGGCTG
TATACG_CGAGGCTG	CGAGGCTG	TATACG	CGAGGCTG
AGTGAT_CGAGGCTG	CGAGGCTG	AGTGAT	CGAGGCTG
CACATA_CGAGGCTG	CGAGGCTG	CACATA	CGAGGCTG
GTATAC_CGAGGCTG	CGAGGCTG	GTATAC	CGAGGCTG
AGTCAG_CGAGGCTG	CGAGGCTG	AGTCAG	CGAGGCTG
CTGCGT_CGAGGCTG	CGAGGCTG	CTGCGT	CGAGGCTG
AGTGCA_CGAGGCTG	CGAGGCTG	AGTGCA	CGAGGCTG
CGACTC_CGAGGCTG	CGAGGCTG	CGACTC	CGAGGCTG
CTGACG_CGAGGCTG	CGAGGCTG	CTGACG	CGAGGCTG
AGTAGC_CGAGGCTG	CGAGGCTG	AGTAGC	CGAGGCTG
ATCACG_CGAGGCTG	CGAGGCTG	ATCACG	CGAGGCTG
ACAGAT_CGAGGCTG	CGAGGCTG	ACAGAT	CGAGGCTG
ATCGCA_CGAGGCTG	CGAGGCTG	ATCGCA	CGAGGCTG
ACAGTG_CGAGGCTG	CGAGGCTG	ACAGTG	CGAGGCTG
CGACGT_CGAGGCTG	CGAGGCTG	CGACGT	CGAGGCTG
AGTACG_CGAGGCTG	CGAGGCTG	AGTACG	CGAGGCTG
GTACAG_CGAGGCTG	CGAGGCTG	GTACAG	CGAGGCTG
GAGTCT_CGAGGCTG	CGAGGCTG	GAGTCT	CGAGGCTG
CTGCAG_CGAGGCTG	CGAGGCTG	CTGCAG	CGAGGCTG
ATCTCT_CGAGGCTG	CGAGGCTG	ATCTCT	CGAGGCTG
CGAGCA_CGAGGCTG	CGAGGCTG	CGAGCA	CGAGGCTG
CGACAG_CGAGGCTG	CGAGGCTG	CGACAG	CGAGGCTG
GCTGAT_CGAGGCTG	CGAGGCTG	GCTGAT	CGAGGCTG
GCTGCA_CGAGGCTG	CGAGGCTG	GCTGCA	CGAGGCTG
CGAGAT_CGAGGCTG	CGAGGCTG	CGAGAT	CGAGGCTG
GCTATA_CGAGGCTG	CGAGGCTG	GCTATA	CGAGGCTG
ATCTAC_CGAGGCTG	CGAGGCTG	ATCTAC	CGAGGCTG
AGTGTG_CGAGGCTG	CGAGGCTG	AGTGTG	CGAGGCTG
GCTAGC_CGAGGCTG	CGAGGCTG	GCTAGC	CGAGGCTG
ACACTC_CGAGGCTG	CGAGGCTG	ACACTC	CGAGGCTG
CACTCT_CGAGGCTG	CGAGGCTG	CACTCT	CGAGGCTG
CACGAT_CGAGGCTG	CGAGGCTG	CACGAT	CGAGGCTG
TATAGC_CGAGGCTG	CGAGGCTG	TATAGC	CGAGGCTG
GAGCAG_CGAGGCTG	CGAGGCTG	GAGCAG	CGAGGCTG
CACACG_CGAGGCTG	CGAGGCTG	CACACG	CGAGGCTG
GTAGCA_CGAGGCTG	CGAGGCTG	GTAGCA	CGAGGCTG
GTAGAT_CGAGGCTG	CGAGGCTG	GTAGAT	CGAGGCTG
CTGTAC_CGAGGCTG	CGAGGCTG	CTGTAC	CGAGGCTG
GAGACG_CGAGGCTG	CGAGGCTG	GAGACG	CGAGGCTG
CACAGC_CGAGGCTG	CGAGGCTG	CACAGC	CGAGGCTG
GTACTC_CGAGGCTG	CGAGGCTG	GTACTC	CGAGGCTG
ACATAC_CGAGGCTG	CGAGGCTG	ACATAC	CGAGGCTG
GTACGT_CGAGGCTG	CGAGGCTG	GTACGT	CGAGGCTG
ACACGT_CGAGGCTG	CGAGGCTG	ACACGT	CGAGGCTG
TATGTG_CGAGGCTG	CGAGGCTG	TATGTG	CGAGGCTG
GAGTGA_CGAGGCTG	CGAGGCTG	GAGTGA	CGAGGCTG
ACACAG_CGAGGCTG	CGAGGCTG	ACACAG	CGAGGCTG
CTGCTC_CGAGGCTG	CGAGGCTG	CTGCTC	CGAGGCTG
AGTCGT_AAGAGGCA	AAGAGGCA	AGTCGT	AAGAGGCA
ATCGCA_AAGAGGCA	AAGAGGCA	ATCGCA	AAGAGGCA
CTGAGC_AAGAGGCA	AAGAGGCA	CTGAGC	AAGAGGCA
GAGCGT_AAGAGGCA	AAGAGGCA	GAGCGT	AAGAGGCA
CTGCAG_AAGAGGCA	AAGAGGCA	CTGCAG	AAGAGGCA
AGTACG_AAGAGGCA	AAGAGGCA	AGTACG	AAGAGGCA
ACATAC_AAGAGGCA	AAGAGGCA	ACATAC	AAGAGGCA
AGTAGC_AAGAGGCA	AAGAGGCA	AGTAGC	AAGAGGCA
AGTGAT_AAGAGGCA	AAGAGGCA	AGTGAT	AAGAGGCA
GAGCAG_AAGAGGCA	AAGAGGCA	GAGCAG	AAGAGGCA
GTAGCA_AAGAGGCA	AAGAGGCA	GTAGCA	AAGAGGCA
ACAGCA_AAGAGGCA	AAGAGGCA	ACAGCA	AAGAGGCA
CGAGTG_AAGAGGCA	AAGAGGCA	CGAGTG	AAGAGGCA
CACTCT_AAGAGGCA	AAGAGGCA	CACTCT	AAGAGGCA
ACACTC_AAGAGGCA	AAGAGGCA	ACACTC	AAGAGGCA
TATAGC_AAGAGGCA	AAGAGGCA	TATAGC	AAGAGGCA
TATGTG_AAGAGGCA	AAGAGGCA	TATGTG	AAGAGGCA
CGACGT_AAGAGGCA	AAGAGGCA	CGACGT	AAGAGGCA
CGATAC_AAGAGGCA	AAGAGGCA	CGATAC	AAGAGGCA
GAGACG_AAGAGGCA	AAGAGGCA	GAGACG	AAGAGGCA
GCTATA_AAGAGGCA	AAGAGGCA	GCTATA	AAGAGGCA
AGTGTG_AAGAGGCA	AAGAGGCA	AGTGTG	AAGAGGCA
CGACAG_AAGAGGCA	AAGAGGCA	CGACAG	AAGAGGCA
ACAGAT_AAGAGGCA	AAGAGGCA	ACAGAT	AAGAGGCA
CGACTC_AAGAGGCA	AAGAGGCA	CGACTC	AAGAGGCA
GCTACG_AAGAGGCA	AAGAGGCA	GCTACG	AAGAGGCA
GTAGAT_AAGAGGCA	AAGAGGCA	GTAGAT	AAGAGGCA
ATCAGC_AAGAGGCA	AAGAGGCA	ATCAGC	AAGAGGCA
CACTAC_AAGAGGCA	AAGAGGCA	CACTAC	AAGAGGCA
GCTGCA_AAGAGGCA	AAGAGGCA	GCTGCA	AAGAGGCA
CTGACG_AAGAGGCA	AAGAGGCA	CTGACG	AAGAGGCA
CACACG_AAGAGGCA	AAGAGGCA	CACACG	AAGAGGCA
CACATA_AAGAGGCA	AAGAGGCA	CACATA	AAGAGGCA
ATCACG_AAGAGGCA	AAGAGGCA	ATCACG	AAGAGGCA
ACAGTG_AAGAGGCA	AAGAGGCA	ACAGTG	AAGAGGCA
CGAGCA_AAGAGGCA	AAGAGGCA	CGAGCA	AAGAGGCA
AGTCAG_AAGAGGCA	AAGAGGCA	AGTCAG	AAGAGGCA
CTGTAC_AAGAGGCA	AAGAGGCA	CTGTAC	AAGAGGCA
GAGTGA_AAGAGGCA	AAGAGGCA	GAGTGA	AAGAGGCA
AGTCTC_AAGAGGCA	AAGAGGCA	AGTCTC	AAGAGGCA
GTAGTG_AAGAGGCA	AAGAGGCA	GTAGTG	AAGAGGCA
GCTGAT_AAGAGGCA	AAGAGGCA	GCTGAT	AAGAGGCA
GCTAGC_AAGAGGCA	AAGAGGCA	GCTAGC	AAGAGGCA
ACACAG_AAGAGGCA	AAGAGGCA	ACACAG	AAGAGGCA
TATACG_AAGAGGCA	AAGAGGCA	TATACG	AAGAGGCA
GTACAG_AAGAGGCA	AAGAGGCA	GTACAG	AAGAGGCA
GAGTAC_AAGAGGCA	AAGAGGCA	GAGTAC	AAGAGGCA
GCTCAG_AAGAGGCA	AAGAGGCA	GCTCAG	AAGAGGCA
GTACTC_AAGAGGCA	AAGAGGCA	GTACTC	AAGAGGCA
CACAGC_AAGAGGCA	AAGAGGCA	CACAGC	AAGAGGCA
CTGCGT_AAGAGGCA	AAGAGGCA	CTGCGT	AAGAGGCA
AGTGCA_AAGAGGCA	AAGAGGCA	AGTGCA	AAGAGGCA
ATCTCT_AAGAGGCA	AAGAGGCA	ATCTCT	AAGAGGCA
CTGCTC_AAGAGGCA	AAGAGGCA	CTGCTC	AAGAGGCA
GTACGT_AAGAGGCA	AAGAGGCA	GTACGT	AAGAGGCA
GAGTCT_AAGAGGCA	AAGAGGCA	GAGTCT	AAGAGGCA
GTATAC_AAGAGGCA	AAGAGGCA	GTATAC	AAGAGGCA
ATCGAT_AAGAGGCA	AAGAGGCA	ATCGAT	AAGAGGCA
ATCTGA_AAGAGGCA	AAGAGGCA	ATCTGA	AAGAGGCA
ACACGT_AAGAGGCA	AAGAGGCA	ACACGT	AAGAGGCA
CGAGAT_AAGAGGCA	AAGAGGCA	CGAGAT	AAGAGGCA
CACGAT_AAGAGGCA	AAGAGGCA	CACGAT	AAGAGGCA
ATCTAC_AAGAGGCA	AAGAGGCA	ATCTAC	AAGAGGCA
TATGCA_AAGAGGCA	AAGAGGCA	TATGCA	AAGAGGCA
GTATAC_GTAGAGGA	GTAGAGGA	GTATAC	GTAGAGGA
GTACTC_GTAGAGGA	GTAGAGGA	GTACTC	GTAGAGGA
AGTGAT_GTAGAGGA	GTAGAGGA	AGTGAT	GTAGAGGA
TATGTG_GTAGAGGA	GTAGAGGA	TATGTG	GTAGAGGA
ATCACG_GTAGAGGA	GTAGAGGA	ATCACG	GTAGAGGA
CTGCTC_GTAGAGGA	GTAGAGGA	CTGCTC	GTAGAGGA
ACAGTG_GTAGAGGA	GTAGAGGA	ACAGTG	GTAGAGGA
GCTATA_GTAGAGGA	GTAGAGGA	GCTATA	GTAGAGGA
GAGTGA_GTAGAGGA	GTAGAGGA	GAGTGA	GTAGAGGA
AGTGCA_GTAGAGGA	GTAGAGGA	AGTGCA	GTAGAGGA
CACATA_GTAGAGGA	GTAGAGGA	CACATA	GTAGAGGA
CGATCT_GTAGAGGA	GTAGAGGA	CGATCT	GTAGAGGA
TATGCA_GTAGAGGA	GTAGAGGA	TATGCA	GTAGAGGA
AGTCTC_GTAGAGGA	GTAGAGGA	AGTCTC	GTAGAGGA
GCTGAT_GTAGAGGA	GTAGAGGA	GCTGAT	GTAGAGGA
GTACAG_GTAGAGGA	GTAGAGGA	GTACAG	GTAGAGGA
CTGAGC_GTAGAGGA	GTAGAGGA	CTGAGC	GTAGAGGA
GAGTAC_GTAGAGGA	GTAGAGGA	GAGTAC	GTAGAGGA
CTGCGT_GTAGAGGA	GTAGAGGA	CTGCGT	GTAGAGGA
GTAGCA_GTAGAGGA	GTAGAGGA	GTAGCA	GTAGAGGA
CTGTAC_GTAGAGGA	GTAGAGGA	CTGTAC	GTAGAGGA
ACACTC_GTAGAGGA	GTAGAGGA	ACACTC	GTAGAGGA
GAGCAG_GTAGAGGA	GTAGAGGA	GAGCAG	GTAGAGGA
GCTACG_GTAGAGGA	GTAGAGGA	GCTACG	GTAGAGGA
CACTCT_GTAGAGGA	GTAGAGGA	CACTCT	GTAGAGGA
AGTACG_GTAGAGGA	GTAGAGGA	AGTACG	GTAGAGGA
CGACGT_GTAGAGGA	GTAGAGGA	CGACGT	GTAGAGGA
ACACAG_GTAGAGGA	GTAGAGGA	ACACAG	GTAGAGGA
CGAGAT_GTAGAGGA	GTAGAGGA	CGAGAT	GTAGAGGA
CGAGTG_GTAGAGGA	GTAGAGGA	CGAGTG	GTAGAGGA
TATAGC_GTAGAGGA	GTAGAGGA	TATAGC	GTAGAGGA
CACACG_GTAGAGGA	GTAGAGGA	CACACG	GTAGAGGA
ATCGAT_GTAGAGGA	GTAGAGGA	ATCGAT	GTAGAGGA
CACAGC_GTAGAGGA	GTAGAGGA	CACAGC	GTAGAGGA
CACGAT_GTAGAGGA	GTAGAGGA	CACGAT	GTAGAGGA
ACAGAT_GTAGAGGA	GTAGAGGA	ACAGAT	GTAGAGGA
CGACAG_GTAGAGGA	GTAGAGGA	CGACAG	GTAGAGGA
GTAGAT_GTAGAGGA	GTAGAGGA	GTAGAT	GTAGAGGA
AGTCGT_GTAGAGGA	GTAGAGGA	AGTCGT	GTAGAGGA
AGTGTG_GTAGAGGA	GTAGAGGA	AGTGTG	GTAGAGGA
GTACGT_GTAGAGGA	GTAGAGGA	GTACGT	GTAGAGGA
GAGCGT_GTAGAGGA	GTAGAGGA	GAGCGT	GTAGAGGA
ATCTCT_GTAGAGGA	GTAGAGGA	ATCTCT	GTAGAGGA
ACATAC_GTAGAGGA	GTAGAGGA	ACATAC	GTAGAGGA
ATCTGA_GTAGAGGA	GTAGAGGA	ATCTGA	GTAGAGGA
CTGCAG_GTAGAGGA	GTAGAGGA	CTGCAG	GTAGAGGA
GTAGTG_GTAGAGGA	GTAGAGGA	GTAGTG	GTAGAGGA
CACTAC_GTAGAGGA	GTAGAGGA	CACTAC	GTAGAGGA
GCTGCA_GTAGAGGA	GTAGAGGA	GCTGCA	GTAGAGGA
GAGTCT_GTAGAGGA	GTAGAGGA	GAGTCT	GTAGAGGA
AGTAGC_GTAGAGGA	GTAGAGGA	AGTAGC	GTAGAGGA
ATCGCA_GTAGAGGA	GTAGAGGA	ATCGCA	GTAGAGGA
ACAGCA_GTAGAGGA	GTAGAGGA	ACAGCA	GTAGAGGA
CGATAC_GTAGAGGA	GTAGAGGA	CGATAC	GTAGAGGA
CGACTC_GTAGAGGA	GTAGAGGA	CGACTC	GTAGAGGA
AGTCAG_GTAGAGGA	GTAGAGGA	AGTCAG	GTAGAGGA
CGAGCA_GTAGAGGA	GTAGAGGA	CGAGCA	GTAGAGGA
TATACG_GTAGAGGA	GTAGAGGA	TATACG	GTAGAGGA
ATCTAC_GTAGAGGA	GTAGAGGA	ATCTAC	GTAGAGGA
CTGACG_GTAGAGGA	GTAGAGGA	CTGACG	GTAGAGGA
GAGACG_GTAGAGGA	GTAGAGGA	GAGACG	GTAGAGGA
ACACGT_GTAGAGGA	GTAGAGGA	ACACGT	GTAGAGGA
GCTAGC_GTAGAGGA	GTAGAGGA	GCTAGC	GTAGAGGA
GCTCAG_GTAGAGGA	GTAGAGGA	GCTCAG	GTAGAGGA
TATGCA_GCTCATGA	GCTCATGA	TATGCA	GCTCATGA
AGTACG_GCTCATGA	GCTCATGA	AGTACG	GCTCATGA
ACACAG_GCTCATGA	GCTCATGA	ACACAG	GCTCATGA
GAGCGT_GCTCATGA	GCTCATGA	GAGCGT	GCTCATGA
GCTGAT_GCTCATGA	GCTCATGA	GCTGAT	GCTCATGA
CACATA_GCTCATGA	GCTCATGA	CACATA	GCTCATGA
GTATAC_GCTCATGA	GCTCATGA	GTATAC	GCTCATGA
ACATAC_GCTCATGA	GCTCATGA	ACATAC	GCTCATGA
CGATAC_GCTCATGA	GCTCATGA	CGATAC	GCTCATGA
GTATCT_GCTCATGA	GCTCATGA	GTATCT	GCTCATGA
GTACGT_GCTCATGA	GCTCATGA	GTACGT	GCTCATGA
AGTAGC_GCTCATGA	GCTCATGA	AGTAGC	GCTCATGA
AGTGTG_GCTCATGA	GCTCATGA	AGTGTG	GCTCATGA
CGACAG_GCTCATGA	GCTCATGA	CGACAG	GCTCATGA
CACTCT_GCTCATGA	GCTCATGA	CACTCT	GCTCATGA
ATCTAC_GCTCATGA	GCTCATGA	ATCTAC	GCTCATGA
CGACGT_GCTCATGA	GCTCATGA	CGACGT	GCTCATGA
ATCGAT_GCTCATGA	GCTCATGA	ATCGAT	GCTCATGA
GCTAGC_GCTCATGA	GCTCATGA	GCTAGC	GCTCATGA
GCTATA_GCTCATGA	GCTCATGA	GCTATA	GCTCATGA
CTGACG_GCTCATGA	GCTCATGA	CTGACG	GCTCATGA
ACACTC_GCTCATGA	GCTCATGA	ACACTC	GCTCATGA
GAGTGA_GCTCATGA	GCTCATGA	GAGTGA	GCTCATGA
AGTGCA_GCTCATGA	GCTCATGA	AGTGCA	GCTCATGA
CTGCTC_GCTCATGA	GCTCATGA	CTGCTC	GCTCATGA
CGAGCA_GCTCATGA	GCTCATGA	CGAGCA	GCTCATGA
CACTAC_GCTCATGA	GCTCATGA	CACTAC	GCTCATGA
GAGCAG_GCTCATGA	GCTCATGA	GAGCAG	GCTCATGA
CTGTAC_GCTCATGA	GCTCATGA	CTGTAC	GCTCATGA
GTAGCA_GCTCATGA	GCTCATGA	GTAGCA	GCTCATGA
GAGACG_GCTCATGA	GCTCATGA	GAGACG	GCTCATGA
ACAGCA_GCTCATGA	GCTCATGA	ACAGCA	GCTCATGA
GAGTCT_GCTCATGA	GCTCATGA	GAGTCT	GCTCATGA
CTGAGC_GCTCATGA	GCTCATGA	CTGAGC	GCTCATGA
ATCACG_GCTCATGA	GCTCATGA	ATCACG	GCTCATGA
CGAGTG_GCTCATGA	GCTCATGA	CGAGTG	GCTCATGA
AGTCTC_GCTCATGA	GCTCATGA	AGTCTC	GCTCATGA
GTACTC_GCTCATGA	GCTCATGA	GTACTC	GCTCATGA
GCTACG_GCTCATGA	GCTCATGA	GCTACG	GCTCATGA
ACACGT_GCTCATGA	GCTCATGA	ACACGT	GCTCATGA
CTGCAG_GCTCATGA	GCTCATGA	CTGCAG	GCTCATGA
AGTCAG_GCTCATGA	GCTCATGA	AGTCAG	GCTCATGA
GCTGCA_GCTCATGA	GCTCATGA	GCTGCA	GCTCATGA
ATCTGA_GCTCATGA	GCTCATGA	ATCTGA	GCTCATGA
TATACG_GCTCATGA	GCTCATGA	TATACG	GCTCATGA
CGACTC_GCTCATGA	GCTCATGA	CGACTC	GCTCATGA
ATCTCT_GCTCATGA	GCTCATGA	ATCTCT	GCTCATGA
ATCGCA_GCTCATGA	GCTCATGA	ATCGCA	GCTCATGA
AGTCGT_GCTCATGA	GCTCATGA	AGTCGT	GCTCATGA
GTAGTG_GCTCATGA	GCTCATGA	GTAGTG	GCTCATGA
GTACAG_GCTCATGA	GCTCATGA	GTACAG	GCTCATGA
CACACG_GCTCATGA	GCTCATGA	CACACG	GCTCATGA
CACGAT_GCTCATGA	GCTCATGA	CACGAT	GCTCATGA
TATAGC_GCTCATGA	GCTCATGA	TATAGC	GCTCATGA
ACAGTG_GCTCATGA	GCTCATGA	ACAGTG	GCTCATGA
TATGTG_GCTCATGA	GCTCATGA	TATGTG	GCTCATGA
CTGCGT_GCTCATGA	GCTCATGA	CTGCGT	GCTCATGA
CGAGAT_GCTCATGA	GCTCATGA	CGAGAT	GCTCATGA
CACAGC_GCTCATGA	GCTCATGA	CACAGC	GCTCATGA
GCTCAG_GCTCATGA	GCTCATGA	GCTCAG	GCTCATGA
ACAGAT_GCTCATGA	GCTCATGA	ACAGAT	GCTCATGA
GAGTAC_GCTCATGA	GCTCATGA	GAGTAC	GCTCATGA
AGTGAT_GCTCATGA	GCTCATGA	AGTGAT	GCTCATGA
GTAGAT_GCTCATGA	GCTCATGA	GTAGAT	GCTCATGA
ATCTCT_ATCTCAGG	ATCTCAGG	ATCTCT	ATCTCAGG
CTGCTC_ATCTCAGG	ATCTCAGG	CTGCTC	ATCTCAGG
GTAGTG_ATCTCAGG	ATCTCAGG	GTAGTG	ATCTCAGG
ACACAG_ATCTCAGG	ATCTCAGG	ACACAG	ATCTCAGG
AGTGTG_ATCTCAGG	ATCTCAGG	AGTGTG	ATCTCAGG
GTACTC_ATCTCAGG	ATCTCAGG	GTACTC	ATCTCAGG
ACAGTG_ATCTCAGG	ATCTCAGG	ACAGTG	ATCTCAGG
ATCTGA_ATCTCAGG	ATCTCAGG	ATCTGA	ATCTCAGG
GTAGCA_ATCTCAGG	ATCTCAGG	GTAGCA	ATCTCAGG
AGTAGC_ATCTCAGG	ATCTCAGG	AGTAGC	ATCTCAGG
GTAGAT_ATCTCAGG	ATCTCAGG	GTAGAT	ATCTCAGG
CTGAGC_ATCTCAGG	ATCTCAGG	CTGAGC	ATCTCAGG
AGTCGT_ATCTCAGG	ATCTCAGG	AGTCGT	ATCTCAGG
CACGAT_ATCTCAGG	ATCTCAGG	CACGAT	ATCTCAGG
GCTACG_ATCTCAGG	ATCTCAGG	GCTACG	ATCTCAGG
GAGCAG_ATCTCAGG	ATCTCAGG	GAGCAG	ATCTCAGG
CGAGAT_ATCTCAGG	ATCTCAGG	CGAGAT	ATCTCAGG
GCTCAG_ATCTCAGG	ATCTCAGG	GCTCAG	ATCTCAGG
TATGCA_ATCTCAGG	ATCTCAGG	TATGCA	ATCTCAGG
GCTAGC_ATCTCAGG	ATCTCAGG	GCTAGC	ATCTCAGG
GCTGAT_ATCTCAGG	ATCTCAGG	GCTGAT	ATCTCAGG
ACATAC_ATCTCAGG	ATCTCAGG	ACATAC	ATCTCAGG
GCTGCA_ATCTCAGG	ATCTCAGG	GCTGCA	ATCTCAGG
ATCACG_ATCTCAGG	ATCTCAGG	ATCACG	ATCTCAGG
GAGCGT_ATCTCAGG	ATCTCAGG	GAGCGT	ATCTCAGG
CTGTAC_ATCTCAGG	ATCTCAGG	CTGTAC	ATCTCAGG
TATACG_ATCTCAGG	ATCTCAGG	TATACG	ATCTCAGG
CGATCT_ATCTCAGG	ATCTCAGG	CGATCT	ATCTCAGG
ATCTAC_ATCTCAGG	ATCTCAGG	ATCTAC	ATCTCAGG
GAGACG_ATCTCAGG	ATCTCAGG	GAGACG	ATCTCAGG
AGTCAG_ATCTCAGG	ATCTCAGG	AGTCAG	ATCTCAGG
AGTACG_ATCTCAGG	ATCTCAGG	AGTACG	ATCTCAGG
GAGTAC_ATCTCAGG	ATCTCAGG	GAGTAC	ATCTCAGG
CGAGTG_ATCTCAGG	ATCTCAGG	CGAGTG	ATCTCAGG
CTGCAG_ATCTCAGG	ATCTCAGG	CTGCAG	ATCTCAGG
CACTAC_ATCTCAGG	ATCTCAGG	CACTAC	ATCTCAGG
CGAGCA_ATCTCAGG	ATCTCAGG	CGAGCA	ATCTCAGG
CGACAG_ATCTCAGG	ATCTCAGG	CGACAG	ATCTCAGG
CACATA_ATCTCAGG	ATCTCAGG	CACATA	ATCTCAGG
GAGTGA_ATCTCAGG	ATCTCAGG	GAGTGA	ATCTCAGG
CTGCGT_ATCTCAGG	ATCTCAGG	CTGCGT	ATCTCAGG
GAGTCT_ATCTCAGG	ATCTCAGG	GAGTCT	ATCTCAGG
ACACTC_ATCTCAGG	ATCTCAGG	ACACTC	ATCTCAGG
AGTGAT_ATCTCAGG	ATCTCAGG	AGTGAT	ATCTCAGG
CACACG_ATCTCAGG	ATCTCAGG	CACACG	ATCTCAGG
CGATAC_ATCTCAGG	ATCTCAGG	CGATAC	ATCTCAGG
GTATAC_ATCTCAGG	ATCTCAGG	GTATAC	ATCTCAGG
ATCGCA_ATCTCAGG	ATCTCAGG	ATCGCA	ATCTCAGG
ACAGCA_ATCTCAGG	ATCTCAGG	ACAGCA	ATCTCAGG
TATAGC_ATCTCAGG	ATCTCAGG	TATAGC	ATCTCAGG
CGACTC_ATCTCAGG	ATCTCAGG	CGACTC	ATCTCAGG
AGTCTC_ATCTCAGG	ATCTCAGG	AGTCTC	ATCTCAGG
AGTGCA_ATCTCAGG	ATCTCAGG	AGTGCA	ATCTCAGG
GCTATA_ATCTCAGG	ATCTCAGG	GCTATA	ATCTCAGG
CTGACG_ATCTCAGG	ATCTCAGG	CTGACG	ATCTCAGG
ATCGAT_ATCTCAGG	ATCTCAGG	ATCGAT	ATCTCAGG
CACTCT_ATCTCAGG	ATCTCAGG	CACTCT	ATCTCAGG
TATGTG_ATCTCAGG	ATCTCAGG	TATGTG	ATCTCAGG
ACAGAT_ATCTCAGG	ATCTCAGG	ACAGAT	ATCTCAGG
ACACGT_ATCTCAGG	ATCTCAGG	ACACGT	ATCTCAGG
CGACGT_ATCTCAGG	ATCTCAGG	CGACGT	ATCTCAGG
CACAGC_ATCTCAGG	ATCTCAGG	CACAGC	ATCTCAGG
GTACAG_ATCTCAGG	ATCTCAGG	GTACAG	ATCTCAGG
GTACGT_ATCTCAGG	ATCTCAGG	GTACGT	ATCTCAGG
GTAGTG_ACTCGCTA	ACTCGCTA	GTAGTG	ACTCGCTA
ATCGCA_ACTCGCTA	ACTCGCTA	ATCGCA	ACTCGCTA
AGTGAT_ACTCGCTA	ACTCGCTA	AGTGAT	ACTCGCTA
GAGACG_ACTCGCTA	ACTCGCTA	GAGACG	ACTCGCTA
ACACAG_ACTCGCTA	ACTCGCTA	ACACAG	ACTCGCTA
CACTAC_ACTCGCTA	ACTCGCTA	CACTAC	ACTCGCTA
ACAGCA_ACTCGCTA	ACTCGCTA	ACAGCA	ACTCGCTA
GCTAGC_ACTCGCTA	ACTCGCTA	GCTAGC	ACTCGCTA
CACACG_ACTCGCTA	ACTCGCTA	CACACG	ACTCGCTA
CGAGCA_ACTCGCTA	ACTCGCTA	CGAGCA	ACTCGCTA
CACGAT_ACTCGCTA	ACTCGCTA	CACGAT	ACTCGCTA
ATCACG_ACTCGCTA	ACTCGCTA	ATCACG	ACTCGCTA
GAGCGT_ACTCGCTA	ACTCGCTA	GAGCGT	ACTCGCTA
GTAGCA_ACTCGCTA	ACTCGCTA	GTAGCA	ACTCGCTA
GTATAC_ACTCGCTA	ACTCGCTA	GTATAC	ACTCGCTA
GAGTAC_ACTCGCTA	ACTCGCTA	GAGTAC	ACTCGCTA
GAGTCT_ACTCGCTA	ACTCGCTA	GAGTCT	ACTCGCTA
CGATAC_ACTCGCTA	ACTCGCTA	CGATAC	ACTCGCTA
ATCTGA_ACTCGCTA	ACTCGCTA	ATCTGA	ACTCGCTA
CGACTC_ACTCGCTA	ACTCGCTA	CGACTC	ACTCGCTA
CGAGAT_ACTCGCTA	ACTCGCTA	CGAGAT	ACTCGCTA
CGAGTG_ACTCGCTA	ACTCGCTA	CGAGTG	ACTCGCTA
AGTGCA_ACTCGCTA	ACTCGCTA	AGTGCA	ACTCGCTA
AGTAGC_ACTCGCTA	ACTCGCTA	AGTAGC	ACTCGCTA
GTACGT_ACTCGCTA	ACTCGCTA	GTACGT	ACTCGCTA
ACATAC_ACTCGCTA	ACTCGCTA	ACATAC	ACTCGCTA
AGTGTG_ACTCGCTA	ACTCGCTA	AGTGTG	ACTCGCTA
GCTGAT_ACTCGCTA	ACTCGCTA	GCTGAT	ACTCGCTA
GAGCAG_ACTCGCTA	ACTCGCTA	GAGCAG	ACTCGCTA
CACAGC_ACTCGCTA	ACTCGCTA	CACAGC	ACTCGCTA
GCTCAG_ACTCGCTA	ACTCGCTA	GCTCAG	ACTCGCTA
AGTCGT_ACTCGCTA	ACTCGCTA	AGTCGT	ACTCGCTA
CTGAGC_ACTCGCTA	ACTCGCTA	CTGAGC	ACTCGCTA
TATGTG_ACTCGCTA	ACTCGCTA	TATGTG	ACTCGCTA
CACATA_ACTCGCTA	ACTCGCTA	CACATA	ACTCGCTA
GTAGAT_ACTCGCTA	ACTCGCTA	GTAGAT	ACTCGCTA
GCTACG_ACTCGCTA	ACTCGCTA	GCTACG	ACTCGCTA
TATAGC_ACTCGCTA	ACTCGCTA	TATAGC	ACTCGCTA
CGACGT_ACTCGCTA	ACTCGCTA	CGACGT	ACTCGCTA
CTGTAC_ACTCGCTA	ACTCGCTA	CTGTAC	ACTCGCTA
GTACTC_ACTCGCTA	ACTCGCTA	GTACTC	ACTCGCTA
CTGCTC_ACTCGCTA	ACTCGCTA	CTGCTC	ACTCGCTA
ACAGTG_ACTCGCTA	ACTCGCTA	ACAGTG	ACTCGCTA
TATGCA_ACTCGCTA	ACTCGCTA	TATGCA	ACTCGCTA
CACTCT_ACTCGCTA	ACTCGCTA	CACTCT	ACTCGCTA
ACATCT_ACTCGCTA	ACTCGCTA	ACATCT	ACTCGCTA
ATCTCT_ACTCGCTA	ACTCGCTA	ATCTCT	ACTCGCTA
ACACGT_ACTCGCTA	ACTCGCTA	ACACGT	ACTCGCTA
AGTACG_ACTCGCTA	ACTCGCTA	AGTACG	ACTCGCTA
GTACAG_ACTCGCTA	ACTCGCTA	GTACAG	ACTCGCTA
TATACG_ACTCGCTA	ACTCGCTA	TATACG	ACTCGCTA
ACAGAT_ACTCGCTA	ACTCGCTA	ACAGAT	ACTCGCTA
ATCGAT_ACTCGCTA	ACTCGCTA	ATCGAT	ACTCGCTA
ATCTAC_ACTCGCTA	ACTCGCTA	ATCTAC	ACTCGCTA
AGTCAG_ACTCGCTA	ACTCGCTA	AGTCAG	ACTCGCTA
CTGACG_ACTCGCTA	ACTCGCTA	CTGACG	ACTCGCTA
CTGCAG_ACTCGCTA	ACTCGCTA	CTGCAG	ACTCGCTA
CTGCGT_ACTCGCTA	ACTCGCTA	CTGCGT	ACTCGCTA
CGACAG_ACTCGCTA	ACTCGCTA	CGACAG	ACTCGCTA
GCTATA_ACTCGCTA	ACTCGCTA	GCTATA	ACTCGCTA
GCTGCA_ACTCGCTA	ACTCGCTA	GCTGCA	ACTCGCTA
ACACTC_ACTCGCTA	ACTCGCTA	ACACTC	ACTCGCTA
GAGTGA_ACTCGCTA	ACTCGCTA	GAGTGA	ACTCGCTA
AGTCTC_ACTCGCTA	ACTCGCTA	AGTCTC	ACTCGCTA
ACACTC_GGAGCTAC	GGAGCTAC	ACACTC	GGAGCTAC
GTACAG_GGAGCTAC	GGAGCTAC	GTACAG	GGAGCTAC
CACACG_GGAGCTAC	GGAGCTAC	CACACG	GGAGCTAC
ATCTAC_GGAGCTAC	GGAGCTAC	ATCTAC	GGAGCTAC
ACAGTG_GGAGCTAC	GGAGCTAC	ACAGTG	GGAGCTAC
CGAGTG_GGAGCTAC	GGAGCTAC	CGAGTG	GGAGCTAC
GCTCAG_GGAGCTAC	GGAGCTAC	GCTCAG	GGAGCTAC
CACTAC_GGAGCTAC	GGAGCTAC	CACTAC	GGAGCTAC
GAGTCT_GGAGCTAC	GGAGCTAC	GAGTCT	GGAGCTAC
AGTGCA_GGAGCTAC	GGAGCTAC	AGTGCA	GGAGCTAC
ATCGCA_GGAGCTAC	GGAGCTAC	ATCGCA	GGAGCTAC
CGACGT_GGAGCTAC	GGAGCTAC	CGACGT	GGAGCTAC
GCTAGC_GGAGCTAC	GGAGCTAC	GCTAGC	GGAGCTAC
TATACG_GGAGCTAC	GGAGCTAC	TATACG	GGAGCTAC
AGTCGT_GGAGCTAC	GGAGCTAC	AGTCGT	GGAGCTAC
GTATAC_GGAGCTAC	GGAGCTAC	GTATAC	GGAGCTAC
ACAGAT_GGAGCTAC	GGAGCTAC	ACAGAT	GGAGCTAC
GTACTC_GGAGCTAC	GGAGCTAC	GTACTC	GGAGCTAC
TATGTG_GGAGCTAC	GGAGCTAC	TATGTG	GGAGCTAC
CTGCAG_GGAGCTAC	GGAGCTAC	CTGCAG	GGAGCTAC
GAGTAC_GGAGCTAC	GGAGCTAC	GAGTAC	GGAGCTAC
AGTCTC_GGAGCTAC	GGAGCTAC	AGTCTC	GGAGCTAC
CGAGAT_GGAGCTAC	GGAGCTAC	CGAGAT	GGAGCTAC
CGATAC_GGAGCTAC	GGAGCTAC	CGATAC	GGAGCTAC
AGTAGC_GGAGCTAC	GGAGCTAC	AGTAGC	GGAGCTAC
TATAGC_GGAGCTAC	GGAGCTAC	TATAGC	GGAGCTAC
GTAGCA_GGAGCTAC	GGAGCTAC	GTAGCA	GGAGCTAC
CGACAG_GGAGCTAC	GGAGCTAC	CGACAG	GGAGCTAC
CACTCT_GGAGCTAC	GGAGCTAC	CACTCT	GGAGCTAC
GAGACG_GGAGCTAC	GGAGCTAC	GAGACG	GGAGCTAC
ATCTGA_GGAGCTAC	GGAGCTAC	ATCTGA	GGAGCTAC
GTAGTG_GGAGCTAC	GGAGCTAC	GTAGTG	GGAGCTAC
GCTGCA_GGAGCTAC	GGAGCTAC	GCTGCA	GGAGCTAC
ATCACG_GGAGCTAC	GGAGCTAC	ATCACG	GGAGCTAC
GTACGT_GGAGCTAC	GGAGCTAC	GTACGT	GGAGCTAC
GAGTGA_GGAGCTAC	GGAGCTAC	GAGTGA	GGAGCTAC
GCTGAT_GGAGCTAC	GGAGCTAC	GCTGAT	GGAGCTAC
AGTGAT_GGAGCTAC	GGAGCTAC	AGTGAT	GGAGCTAC
CGAGCA_GGAGCTAC	GGAGCTAC	CGAGCA	GGAGCTAC
ACACAG_GGAGCTAC	GGAGCTAC	ACACAG	GGAGCTAC
CTGCTC_GGAGCTAC	GGAGCTAC	CTGCTC	GGAGCTAC
CTGAGC_GGAGCTAC	GGAGCTAC	CTGAGC	GGAGCTAC
GCTATA_GGAGCTAC	GGAGCTAC	GCTATA	GGAGCTAC
CTGTAC_GGAGCTAC	GGAGCTAC	CTGTAC	GGAGCTAC
GCTACG_GGAGCTAC	GGAGCTAC	GCTACG	GGAGCTAC
CGACTC_GGAGCTAC	GGAGCTAC	CGACTC	GGAGCTAC
CACAGC_GGAGCTAC	GGAGCTAC	CACAGC	GGAGCTAC
TATGCA_GGAGCTAC	GGAGCTAC	TATGCA	GGAGCTAC
ACACGT_GGAGCTAC	GGAGCTAC	ACACGT	GGAGCTAC
ATCTCT_GGAGCTAC	GGAGCTAC	ATCTCT	GGAGCTAC
ACATAC_GGAGCTAC	GGAGCTAC	ACATAC	GGAGCTAC
GAGCGT_GGAGCTAC	GGAGCTAC	GAGCGT	GGAGCTAC
GAGCAG_GGAGCTAC	GGAGCTAC	GAGCAG	GGAGCTAC
ATCGAT_GGAGCTAC	GGAGCTAC	ATCGAT	GGAGCTAC
CTGACG_GGAGCTAC	GGAGCTAC	CTGACG	GGAGCTAC
CACGAT_GGAGCTAC	GGAGCTAC	CACGAT	GGAGCTAC
ACAGCA_GGAGCTAC	GGAGCTAC	ACAGCA	GGAGCTAC
CTGCGT_GGAGCTAC	GGAGCTAC	CTGCGT	GGAGCTAC
AGTGTG_GGAGCTAC	GGAGCTAC	AGTGTG	GGAGCTAC
GTATCT_GGAGCTAC	GGAGCTAC	GTATCT	GGAGCTAC
AGTCAG_GGAGCTAC	GGAGCTAC	AGTCAG	GGAGCTAC
AGTACG_GGAGCTAC	GGAGCTAC	AGTACG	GGAGCTAC
GTAGAT_GGAGCTAC	GGAGCTAC	GTAGAT	GGAGCTAC
CACATA_GGAGCTAC	GGAGCTAC	CACATA	GGAGCTAC
GAGTGA_GCGTAGTA	GCGTAGTA	GAGTGA	GCGTAGTA
GCTGCA_GCGTAGTA	GCGTAGTA	GCTGCA	GCGTAGTA
ACAGTG_GCGTAGTA	GCGTAGTA	ACAGTG	GCGTAGTA
GCTCGT_GCGTAGTA	GCGTAGTA	GCTCGT	GCGTAGTA
GTAGTG_GCGTAGTA	GCGTAGTA	GTAGTG	GCGTAGTA
CGACGT_GCGTAGTA	GCGTAGTA	CGACGT	GCGTAGTA
CGAGTG_GCGTAGTA	GCGTAGTA	CGAGTG	GCGTAGTA
CACATA_GCGTAGTA	GCGTAGTA	CACATA	GCGTAGTA
AGTGTG_GCGTAGTA	GCGTAGTA	AGTGTG	GCGTAGTA
GCTATA_GCGTAGTA	GCGTAGTA	GCTATA	GCGTAGTA
GTACGT_GCGTAGTA	GCGTAGTA	GTACGT	GCGTAGTA
CACGAT_GCGTAGTA	GCGTAGTA	CACGAT	GCGTAGTA
CGAGAT_GCGTAGTA	GCGTAGTA	CGAGAT	GCGTAGTA
ATCGAT_GCGTAGTA	GCGTAGTA	ATCGAT	GCGTAGTA
ACAGAT_GCGTAGTA	GCGTAGTA	ACAGAT	GCGTAGTA
GCTACG_GCGTAGTA	GCGTAGTA	GCTACG	GCGTAGTA
GAGTCT_GCGTAGTA	GCGTAGTA	GAGTCT	GCGTAGTA
CACTCT_GCGTAGTA	GCGTAGTA	CACTCT	GCGTAGTA
GTAGCA_GCGTAGTA	GCGTAGTA	GTAGCA	GCGTAGTA
GCTGAT_GCGTAGTA	GCGTAGTA	GCTGAT	GCGTAGTA
CACAGC_GCGTAGTA	GCGTAGTA	CACAGC	GCGTAGTA
CTGCTC_GCGTAGTA	GCGTAGTA	CTGCTC	GCGTAGTA
CTGACG_GCGTAGTA	GCGTAGTA	CTGACG	GCGTAGTA
AGTACG_GCGTAGTA	GCGTAGTA	AGTACG	GCGTAGTA
GAGTAC_GCGTAGTA	GCGTAGTA	GAGTAC	GCGTAGTA
CTGTAC_GCGTAGTA	GCGTAGTA	CTGTAC	GCGTAGTA
AGTCTC_GCGTAGTA	GCGTAGTA	AGTCTC	GCGTAGTA
CACTAC_GCGTAGTA	GCGTAGTA	CACTAC	GCGTAGTA
GCTCAG_GCGTAGTA	GCGTAGTA	GCTCAG	GCGTAGTA
ACATAC_GCGTAGTA	GCGTAGTA	ACATAC	GCGTAGTA
CTGCAG_GCGTAGTA	GCGTAGTA	CTGCAG	GCGTAGTA
GAGCGT_GCGTAGTA	GCGTAGTA	GAGCGT	GCGTAGTA
ACAGCA_GCGTAGTA	GCGTAGTA	ACAGCA	GCGTAGTA
GAGACG_GCGTAGTA	GCGTAGTA	GAGACG	GCGTAGTA
ATCACG_GCGTAGTA	GCGTAGTA	ATCACG	GCGTAGTA
TATAGC_GCGTAGTA	GCGTAGTA	TATAGC	GCGTAGTA
GTACAG_GCGTAGTA	GCGTAGTA	GTACAG	GCGTAGTA
CGAGCA_GCGTAGTA	GCGTAGTA	CGAGCA	GCGTAGTA
CTGAGC_GCGTAGTA	GCGTAGTA	CTGAGC	GCGTAGTA
ATCTAC_GCGTAGTA	GCGTAGTA	ATCTAC	GCGTAGTA
GAGCAG_GCGTAGTA	GCGTAGTA	GAGCAG	GCGTAGTA
GTAGAT_GCGTAGTA	GCGTAGTA	GTAGAT	GCGTAGTA
AGTGAT_GCGTAGTA	GCGTAGTA	AGTGAT	GCGTAGTA
CGACTC_GCGTAGTA	GCGTAGTA	CGACTC	GCGTAGTA
CACACG_GCGTAGTA	GCGTAGTA	CACACG	GCGTAGTA
CGACAG_GCGTAGTA	GCGTAGTA	CGACAG	GCGTAGTA
CGATAC_GCGTAGTA	GCGTAGTA	CGATAC	GCGTAGTA
AGTCGT_GCGTAGTA	GCGTAGTA	AGTCGT	GCGTAGTA
AGTAGC_GCGTAGTA	GCGTAGTA	AGTAGC	GCGTAGTA
AGTCAG_GCGTAGTA	GCGTAGTA	AGTCAG	GCGTAGTA
ACACGT_GCGTAGTA	GCGTAGTA	ACACGT	GCGTAGTA
CTGCGT_GCGTAGTA	GCGTAGTA	CTGCGT	GCGTAGTA
TATGCA_GCGTAGTA	GCGTAGTA	TATGCA	GCGTAGTA
ACACAG_GCGTAGTA	GCGTAGTA	ACACAG	GCGTAGTA
ATCGCA_GCGTAGTA	GCGTAGTA	ATCGCA	GCGTAGTA
GTATAC_GCGTAGTA	GCGTAGTA	GTATAC	GCGTAGTA
TATACG_GCGTAGTA	GCGTAGTA	TATACG	GCGTAGTA
GCTAGC_GCGTAGTA	GCGTAGTA	GCTAGC	GCGTAGTA
GTACTC_GCGTAGTA	GCGTAGTA	GTACTC	GCGTAGTA
ACACTC_GCGTAGTA	GCGTAGTA	ACACTC	GCGTAGTA
ATCTGA_GCGTAGTA	GCGTAGTA	ATCTGA	GCGTAGTA
TATGTG_GCGTAGTA	GCGTAGTA	TATGTG	GCGTAGTA
AGTGCA_GCGTAGTA	GCGTAGTA	AGTGCA	GCGTAGTA
ATCTCT_GCGTAGTA	GCGTAGTA	ATCTCT	GCGTAGTA
GCTGAT_CGGAGCCT	CGGAGCCT	GCTGAT	CGGAGCCT
CTGAGC_CGGAGCCT	CGGAGCCT	CTGAGC	CGGAGCCT
AGTGTG_CGGAGCCT	CGGAGCCT	AGTGTG	CGGAGCCT
ATCACG_CGGAGCCT	CGGAGCCT	ATCACG	CGGAGCCT
AGTCAG_CGGAGCCT	CGGAGCCT	AGTCAG	CGGAGCCT
ACATAC_CGGAGCCT	CGGAGCCT	ACATAC	CGGAGCCT
GCTATA_CGGAGCCT	CGGAGCCT	GCTATA	CGGAGCCT
CACAGC_CGGAGCCT	CGGAGCCT	CACAGC	CGGAGCCT
CTGTAC_CGGAGCCT	CGGAGCCT	CTGTAC	CGGAGCCT
CGACTC_CGGAGCCT	CGGAGCCT	CGACTC	CGGAGCCT
CGATAC_CGGAGCCT	CGGAGCCT	CGATAC	CGGAGCCT
AGTGAT_CGGAGCCT	CGGAGCCT	AGTGAT	CGGAGCCT
GAGTGA_CGGAGCCT	CGGAGCCT	GAGTGA	CGGAGCCT
ACAGAT_CGGAGCCT	CGGAGCCT	ACAGAT	CGGAGCCT
TATAGC_CGGAGCCT	CGGAGCCT	TATAGC	CGGAGCCT
ATCGAT_CGGAGCCT	CGGAGCCT	ATCGAT	CGGAGCCT
GTATAC_CGGAGCCT	CGGAGCCT	GTATAC	CGGAGCCT
GTAGTG_CGGAGCCT	CGGAGCCT	GTAGTG	CGGAGCCT
GCTGCA_CGGAGCCT	CGGAGCCT	GCTGCA	CGGAGCCT
GTATCT_CGGAGCCT	CGGAGCCT	GTATCT	CGGAGCCT
CTGCTC_CGGAGCCT	CGGAGCCT	CTGCTC	CGGAGCCT
ATCTAC_CGGAGCCT	CGGAGCCT	ATCTAC	CGGAGCCT
GCTAGC_CGGAGCCT	CGGAGCCT	GCTAGC	CGGAGCCT
GAGCAG_CGGAGCCT	CGGAGCCT	GAGCAG	CGGAGCCT
AGTCTC_CGGAGCCT	CGGAGCCT	AGTCTC	CGGAGCCT
CGAGCA_CGGAGCCT	CGGAGCCT	CGAGCA	CGGAGCCT
TATGCA_CGGAGCCT	CGGAGCCT	TATGCA	CGGAGCCT
CACACG_CGGAGCCT	CGGAGCCT	CACACG	CGGAGCCT
GAGTAC_CGGAGCCT	CGGAGCCT	GAGTAC	CGGAGCCT
GTAGAT_CGGAGCCT	CGGAGCCT	GTAGAT	CGGAGCCT
ACACTC_CGGAGCCT	CGGAGCCT	ACACTC	CGGAGCCT
CTGACG_CGGAGCCT	CGGAGCCT	CTGACG	CGGAGCCT
GAGACG_CGGAGCCT	CGGAGCCT	GAGACG	CGGAGCCT
AGTCGT_CGGAGCCT	CGGAGCCT	AGTCGT	CGGAGCCT
CTGCGT_CGGAGCCT	CGGAGCCT	CTGCGT	CGGAGCCT
ACACAG_CGGAGCCT	CGGAGCCT	ACACAG	CGGAGCCT
GCTACG_CGGAGCCT	CGGAGCCT	GCTACG	CGGAGCCT
AGTAGC_CGGAGCCT	CGGAGCCT	AGTAGC	CGGAGCCT
CTGCAG_CGGAGCCT	CGGAGCCT	CTGCAG	CGGAGCCT
GTACTC_CGGAGCCT	CGGAGCCT	GTACTC	CGGAGCCT
GTACGT_CGGAGCCT	CGGAGCCT	GTACGT	CGGAGCCT
CACATA_CGGAGCCT	CGGAGCCT	CACATA	CGGAGCCT
CGACAG_CGGAGCCT	CGGAGCCT	CGACAG	CGGAGCCT
GTAGCA_CGGAGCCT	CGGAGCCT	GTAGCA	CGGAGCCT
CGACGT_CGGAGCCT	CGGAGCCT	CGACGT	CGGAGCCT
ATCTCT_CGGAGCCT	CGGAGCCT	ATCTCT	CGGAGCCT
CGAGTG_CGGAGCCT	CGGAGCCT	CGAGTG	CGGAGCCT
GAGCGT_CGGAGCCT	CGGAGCCT	GAGCGT	CGGAGCCT
CGAGAT_CGGAGCCT	CGGAGCCT	CGAGAT	CGGAGCCT
GAGTCT_CGGAGCCT	CGGAGCCT	GAGTCT	CGGAGCCT
AGTGCA_CGGAGCCT	CGGAGCCT	AGTGCA	CGGAGCCT
TATACG_CGGAGCCT	CGGAGCCT	TATACG	CGGAGCCT
AGTACG_CGGAGCCT	CGGAGCCT	AGTACG	CGGAGCCT
ACACGT_CGGAGCCT	CGGAGCCT	ACACGT	CGGAGCCT
GTACAG_CGGAGCCT	CGGAGCCT	GTACAG	CGGAGCCT
CACTAC_CGGAGCCT	CGGAGCCT	CACTAC	CGGAGCCT
CACTCT_CGGAGCCT	CGGAGCCT	CACTCT	CGGAGCCT
ACAGCA_CGGAGCCT	CGGAGCCT	ACAGCA	CGGAGCCT
TATGTG_CGGAGCCT	CGGAGCCT	TATGTG	CGGAGCCT
CACGAT_CGGAGCCT	CGGAGCCT	CACGAT	CGGAGCCT
ATCTGA_CGGAGCCT	CGGAGCCT	ATCTGA	CGGAGCCT
ACAGTG_CGGAGCCT	CGGAGCCT	ACAGTG	CGGAGCCT
GCTCAG_CGGAGCCT	CGGAGCCT	GCTCAG	CGGAGCCT
ATCGCA_CGGAGCCT	CGGAGCCT	ATCGCA	CGGAGCCT
GCTAGC_TACGCTGC	TACGCTGC	GCTAGC	TACGCTGC
ACAGCA_TACGCTGC	TACGCTGC	ACAGCA	TACGCTGC
ATCTGA_TACGCTGC	TACGCTGC	ATCTGA	TACGCTGC
CACACG_TACGCTGC	TACGCTGC	CACACG	TACGCTGC
CACAGC_TACGCTGC	TACGCTGC	CACAGC	TACGCTGC
CACGCA_TACGCTGC	TACGCTGC	CACGCA	TACGCTGC
CGACTC_TACGCTGC	TACGCTGC	CGACTC	TACGCTGC
GCTACG_TACGCTGC	TACGCTGC	GCTACG	TACGCTGC
AGTCTC_TACGCTGC	TACGCTGC	AGTCTC	TACGCTGC
TATACG_TACGCTGC	TACGCTGC	TATACG	TACGCTGC
ACACGT_TACGCTGC	TACGCTGC	ACACGT	TACGCTGC
CTGCAG_TACGCTGC	TACGCTGC	CTGCAG	TACGCTGC
GTAGTG_TACGCTGC	TACGCTGC	GTAGTG	TACGCTGC
TATAGC_TACGCTGC	TACGCTGC	TATAGC	TACGCTGC
GCTCAG_TACGCTGC	TACGCTGC	GCTCAG	TACGCTGC
CTGTAC_TACGCTGC	TACGCTGC	CTGTAC	TACGCTGC
CTGACG_TACGCTGC	TACGCTGC	CTGACG	TACGCTGC
ACACTC_TACGCTGC	TACGCTGC	ACACTC	TACGCTGC
ACAGAT_TACGCTGC	TACGCTGC	ACAGAT	TACGCTGC
GTACAG_TACGCTGC	TACGCTGC	GTACAG	TACGCTGC
GCTATA_TACGCTGC	TACGCTGC	GCTATA	TACGCTGC
CTGCGT_TACGCTGC	TACGCTGC	CTGCGT	TACGCTGC
ACACAG_TACGCTGC	TACGCTGC	ACACAG	TACGCTGC
AGTCAG_TACGCTGC	TACGCTGC	AGTCAG	TACGCTGC
ATCGAT_TACGCTGC	TACGCTGC	ATCGAT	TACGCTGC
CGACAG_TACGCTGC	TACGCTGC	CGACAG	TACGCTGC
ATCTAC_TACGCTGC	TACGCTGC	ATCTAC	TACGCTGC
GAGTAC_TACGCTGC	TACGCTGC	GAGTAC	TACGCTGC
AGTACG_TACGCTGC	TACGCTGC	AGTACG	TACGCTGC
TATGCA_TACGCTGC	TACGCTGC	TATGCA	TACGCTGC
GTAGAT_TACGCTGC	TACGCTGC	GTAGAT	TACGCTGC
CACTCT_TACGCTGC	TACGCTGC	CACTCT	TACGCTGC
GAGTGA_TACGCTGC	TACGCTGC	GAGTGA	TACGCTGC
CTGCTC_TACGCTGC	TACGCTGC	CTGCTC	TACGCTGC
AGTCGT_TACGCTGC	TACGCTGC	AGTCGT	TACGCTGC
CGATAC_TACGCTGC	TACGCTGC	CGATAC	TACGCTGC
ATCGCA_TACGCTGC	TACGCTGC	ATCGCA	TACGCTGC
CACTAC_TACGCTGC	TACGCTGC	CACTAC	TACGCTGC
GTACTC_TACGCTGC	TACGCTGC	GTACTC	TACGCTGC
AGTGCA_TACGCTGC	TACGCTGC	AGTGCA	TACGCTGC
AGTGAT_TACGCTGC	TACGCTGC	AGTGAT	TACGCTGC
GAGCGT_TACGCTGC	TACGCTGC	GAGCGT	TACGCTGC
GTACGT_TACGCTGC	TACGCTGC	GTACGT	TACGCTGC
GTAGCA_TACGCTGC	TACGCTGC	GTAGCA	TACGCTGC
GAGTCT_TACGCTGC	TACGCTGC	GAGTCT	TACGCTGC
CACGAT_TACGCTGC	TACGCTGC	CACGAT	TACGCTGC
CACATA_TACGCTGC	TACGCTGC	CACATA	TACGCTGC
GCTGCA_TACGCTGC	TACGCTGC	GCTGCA	TACGCTGC
CGACGT_TACGCTGC	TACGCTGC	CGACGT	TACGCTGC
CGAGAT_TACGCTGC	TACGCTGC	CGAGAT	TACGCTGC
CGAGCA_TACGCTGC	TACGCTGC	CGAGCA	TACGCTGC
ATCTCT_TACGCTGC	TACGCTGC	ATCTCT	TACGCTGC
ATCACG_TACGCTGC	TACGCTGC	ATCACG	TACGCTGC
GAGCAG_TACGCTGC	TACGCTGC	GAGCAG	TACGCTGC
GTATAC_TACGCTGC	TACGCTGC	GTATAC	TACGCTGC
AGTAGC_TACGCTGC	TACGCTGC	AGTAGC	TACGCTGC
GAGACG_TACGCTGC	TACGCTGC	GAGACG	TACGCTGC
ACATAC_TACGCTGC	TACGCTGC	ACATAC	TACGCTGC
CGAGTG_TACGCTGC	TACGCTGC	CGAGTG	TACGCTGC
AGTGTG_TACGCTGC	TACGCTGC	AGTGTG	TACGCTGC
ACAGTG_TACGCTGC	TACGCTGC	ACAGTG	TACGCTGC
GCTGAT_TACGCTGC	TACGCTGC	GCTGAT	TACGCTGC
CTGAGC_TACGCTGC	TACGCTGC	CTGAGC	TACGCTGC
TATGTG_TACGCTGC	TACGCTGC	TATGTG	TACGCTGC
ACACAG_ATGCGCAG	ATGCGCAG	ACACAG	ATGCGCAG
CGAGCA_ATGCGCAG	ATGCGCAG	CGAGCA	ATGCGCAG
ATCTCT_ATGCGCAG	ATGCGCAG	ATCTCT	ATGCGCAG
GCTCAG_ATGCGCAG	ATGCGCAG	GCTCAG	ATGCGCAG
CTGCAG_ATGCGCAG	ATGCGCAG	CTGCAG	ATGCGCAG
AGTGTG_ATGCGCAG	ATGCGCAG	AGTGTG	ATGCGCAG
GAGTAC_ATGCGCAG	ATGCGCAG	GAGTAC	ATGCGCAG
ACAGAT_ATGCGCAG	ATGCGCAG	ACAGAT	ATGCGCAG
GTACTC_ATGCGCAG	ATGCGCAG	GTACTC	ATGCGCAG
CGACTC_ATGCGCAG	ATGCGCAG	CGACTC	ATGCGCAG
GTAGAT_ATGCGCAG	ATGCGCAG	GTAGAT	ATGCGCAG
ATCTAC_ATGCGCAG	ATGCGCAG	ATCTAC	ATGCGCAG
AGTCAG_ATGCGCAG	ATGCGCAG	AGTCAG	ATGCGCAG
ACAGCA_ATGCGCAG	ATGCGCAG	ACAGCA	ATGCGCAG
GCTACG_ATGCGCAG	ATGCGCAG	GCTACG	ATGCGCAG
GAGCGT_ATGCGCAG	ATGCGCAG	GAGCGT	ATGCGCAG
GAGACG_ATGCGCAG	ATGCGCAG	GAGACG	ATGCGCAG
CACGAT_ATGCGCAG	ATGCGCAG	CACGAT	ATGCGCAG
ACATAC_ATGCGCAG	ATGCGCAG	ACATAC	ATGCGCAG
CACTCT_ATGCGCAG	ATGCGCAG	CACTCT	ATGCGCAG
GCTAGC_ATGCGCAG	ATGCGCAG	GCTAGC	ATGCGCAG
AGTGAT_ATGCGCAG	ATGCGCAG	AGTGAT	ATGCGCAG
ACACTC_ATGCGCAG	ATGCGCAG	ACACTC	ATGCGCAG
CGAGTG_ATGCGCAG	ATGCGCAG	CGAGTG	ATGCGCAG
GTATAC_ATGCGCAG	ATGCGCAG	GTATAC	ATGCGCAG
TATGCA_ATGCGCAG	ATGCGCAG	TATGCA	ATGCGCAG
CTGTAC_ATGCGCAG	ATGCGCAG	CTGTAC	ATGCGCAG
AGTCGT_ATGCGCAG	ATGCGCAG	AGTCGT	ATGCGCAG
CTGAGC_ATGCGCAG	ATGCGCAG	CTGAGC	ATGCGCAG
ACACGT_ATGCGCAG	ATGCGCAG	ACACGT	ATGCGCAG
GTACAG_ATGCGCAG	ATGCGCAG	GTACAG	ATGCGCAG
TATGTG_ATGCGCAG	ATGCGCAG	TATGTG	ATGCGCAG
GCTATA_ATGCGCAG	ATGCGCAG	GCTATA	ATGCGCAG
ATCACG_ATGCGCAG	ATGCGCAG	ATCACG	ATGCGCAG
AGTCTC_ATGCGCAG	ATGCGCAG	AGTCTC	ATGCGCAG
GTACGT_ATGCGCAG	ATGCGCAG	GTACGT	ATGCGCAG
CGAGAT_ATGCGCAG	ATGCGCAG	CGAGAT	ATGCGCAG
CTGACG_ATGCGCAG	ATGCGCAG	CTGACG	ATGCGCAG
ATCTGA_ATGCGCAG	ATGCGCAG	ATCTGA	ATGCGCAG
CTGCTC_ATGCGCAG	ATGCGCAG	CTGCTC	ATGCGCAG
CGACGT_ATGCGCAG	ATGCGCAG	CGACGT	ATGCGCAG
ATCGCA_ATGCGCAG	ATGCGCAG	ATCGCA	ATGCGCAG
AGTACG_ATGCGCAG	ATGCGCAG	AGTACG	ATGCGCAG
ATCGAT_ATGCGCAG	ATGCGCAG	ATCGAT	ATGCGCAG
GAGTCT_ATGCGCAG	ATGCGCAG	GAGTCT	ATGCGCAG
CGATAC_ATGCGCAG	ATGCGCAG	CGATAC	ATGCGCAG
GAGCAG_ATGCGCAG	ATGCGCAG	GAGCAG	ATGCGCAG
CACACG_ATGCGCAG	ATGCGCAG	CACACG	ATGCGCAG
GCTCGT_ATGCGCAG	ATGCGCAG	GCTCGT	ATGCGCAG
CACAGC_ATGCGCAG	ATGCGCAG	CACAGC	ATGCGCAG
CACTAC_ATGCGCAG	ATGCGCAG	CACTAC	ATGCGCAG
ACAGTG_ATGCGCAG	ATGCGCAG	ACAGTG	ATGCGCAG
CTGCGT_ATGCGCAG	ATGCGCAG	CTGCGT	ATGCGCAG
GCTGCA_ATGCGCAG	ATGCGCAG	GCTGCA	ATGCGCAG
TATAGC_ATGCGCAG	ATGCGCAG	TATAGC	ATGCGCAG
CACATA_ATGCGCAG	ATGCGCAG	CACATA	ATGCGCAG
TATACG_ATGCGCAG	ATGCGCAG	TATACG	ATGCGCAG
GTAGCA_ATGCGCAG	ATGCGCAG	GTAGCA	ATGCGCAG
CGACAG_ATGCGCAG	ATGCGCAG	CGACAG	ATGCGCAG
AGTGCA_ATGCGCAG	ATGCGCAG	AGTGCA	ATGCGCAG
GAGTGA_ATGCGCAG	ATGCGCAG	GAGTGA	ATGCGCAG
AGTAGC_ATGCGCAG	ATGCGCAG	AGTAGC	ATGCGCAG
GCTGAT_ATGCGCAG	ATGCGCAG	GCTGAT	ATGCGCAG
GTAGTG_ATGCGCAG	ATGCGCAG	GTAGTG	ATGCGCAG
CACTAC_TAGCGCTC	TAGCGCTC	CACTAC	TAGCGCTC
ACACAG_TAGCGCTC	TAGCGCTC	ACACAG	TAGCGCTC
TATACG_TAGCGCTC	TAGCGCTC	TATACG	TAGCGCTC
ATCTAC_TAGCGCTC	TAGCGCTC	ATCTAC	TAGCGCTC
CGAGCA_TAGCGCTC	TAGCGCTC	CGAGCA	TAGCGCTC
GTAGAT_TAGCGCTC	TAGCGCTC	GTAGAT	TAGCGCTC
AGTCTC_TAGCGCTC	TAGCGCTC	AGTCTC	TAGCGCTC
CGATAC_TAGCGCTC	TAGCGCTC	CGATAC	TAGCGCTC
CGACGT_TAGCGCTC	TAGCGCTC	CGACGT	TAGCGCTC
CTGTAC_TAGCGCTC	TAGCGCTC	CTGTAC	TAGCGCTC
CGAGTG_TAGCGCTC	TAGCGCTC	CGAGTG	TAGCGCTC
GCTCAG_TAGCGCTC	TAGCGCTC	GCTCAG	TAGCGCTC
ATCGCA_TAGCGCTC	TAGCGCTC	ATCGCA	TAGCGCTC
GTAGTG_TAGCGCTC	TAGCGCTC	GTAGTG	TAGCGCTC
AGTACG_TAGCGCTC	TAGCGCTC	AGTACG	TAGCGCTC
CTGACG_TAGCGCTC	TAGCGCTC	CTGACG	TAGCGCTC
CGAGAT_TAGCGCTC	TAGCGCTC	CGAGAT	TAGCGCTC
GAGTAC_TAGCGCTC	TAGCGCTC	GAGTAC	TAGCGCTC
ACACGT_TAGCGCTC	TAGCGCTC	ACACGT	TAGCGCTC
GAGACG_TAGCGCTC	TAGCGCTC	GAGACG	TAGCGCTC
CACATA_TAGCGCTC	TAGCGCTC	CACATA	TAGCGCTC
GAGTGA_TAGCGCTC	TAGCGCTC	GAGTGA	TAGCGCTC
ACACTC_TAGCGCTC	TAGCGCTC	ACACTC	TAGCGCTC
CTGCAG_TAGCGCTC	TAGCGCTC	CTGCAG	TAGCGCTC
CACTCT_TAGCGCTC	TAGCGCTC	CACTCT	TAGCGCTC
CACAGC_TAGCGCTC	TAGCGCTC	CACAGC	TAGCGCTC
TATAGC_TAGCGCTC	TAGCGCTC	TATAGC	TAGCGCTC
ACAGAT_TAGCGCTC	TAGCGCTC	ACAGAT	TAGCGCTC
TATGCA_TAGCGCTC	TAGCGCTC	TATGCA	TAGCGCTC
GCTGCA_TAGCGCTC	TAGCGCTC	GCTGCA	TAGCGCTC
GAGCAG_TAGCGCTC	TAGCGCTC	GAGCAG	TAGCGCTC
GCTAGC_TAGCGCTC	TAGCGCTC	GCTAGC	TAGCGCTC
CTGCGT_TAGCGCTC	TAGCGCTC	CTGCGT	TAGCGCTC
ACAGCA_TAGCGCTC	TAGCGCTC	ACAGCA	TAGCGCTC
TATGTG_TAGCGCTC	TAGCGCTC	TATGTG	TAGCGCTC
AGTAGC_TAGCGCTC	TAGCGCTC	AGTAGC	TAGCGCTC
GTACGT_TAGCGCTC	TAGCGCTC	GTACGT	TAGCGCTC
GAGCGT_TAGCGCTC	TAGCGCTC	GAGCGT	TAGCGCTC
CACACG_TAGCGCTC	TAGCGCTC	CACACG	TAGCGCTC
CACGAT_TAGCGCTC	TAGCGCTC	CACGAT	TAGCGCTC
ATCTGA_TAGCGCTC	TAGCGCTC	ATCTGA	TAGCGCTC
GTAGCA_TAGCGCTC	TAGCGCTC	GTAGCA	TAGCGCTC
TCGAGC_TAGCGCTC	TAGCGCTC	TCGAGC	TAGCGCTC
AGTCAG_TAGCGCTC	TAGCGCTC	AGTCAG	TAGCGCTC
GCTATA_TAGCGCTC	TAGCGCTC	GCTATA	TAGCGCTC
GTACTC_TAGCGCTC	TAGCGCTC	GTACTC	TAGCGCTC
ATCACG_TAGCGCTC	TAGCGCTC	ATCACG	TAGCGCTC
ACATAC_TAGCGCTC	TAGCGCTC	ACATAC	TAGCGCTC
AGTGAT_TAGCGCTC	TAGCGCTC	AGTGAT	TAGCGCTC
GAGTCT_TAGCGCTC	TAGCGCTC	GAGTCT	TAGCGCTC
ATCGAT_TAGCGCTC	TAGCGCTC	ATCGAT	TAGCGCTC
AGTGCA_TAGCGCTC	TAGCGCTC	AGTGCA	TAGCGCTC
CTGAGC_TAGCGCTC	TAGCGCTC	CTGAGC	TAGCGCTC
ACAGTG_TAGCGCTC	TAGCGCTC	ACAGTG	TAGCGCTC
CGACAG_TAGCGCTC	TAGCGCTC	CGACAG	TAGCGCTC
GCTGAT_TAGCGCTC	TAGCGCTC	GCTGAT	TAGCGCTC
GTACAG_TAGCGCTC	TAGCGCTC	GTACAG	TAGCGCTC
AGTCGT_TAGCGCTC	TAGCGCTC	AGTCGT	TAGCGCTC
ATCTCT_TAGCGCTC	TAGCGCTC	ATCTCT	TAGCGCTC
GTATAC_TAGCGCTC	TAGCGCTC	GTATAC	TAGCGCTC
GCTACG_TAGCGCTC	TAGCGCTC	GCTACG	TAGCGCTC
AGTGTG_TAGCGCTC	TAGCGCTC	AGTGTG	TAGCGCTC
CGACTC_TAGCGCTC	TAGCGCTC	CGACTC	TAGCGCTC
CTGCTC_TAGCGCTC	TAGCGCTC	CTGCTC	TAGCGCTC
TCGAGC_ACTGAGCG	ACTGAGCG	TCGAGC	ACTGAGCG
ATCGCA_ACTGAGCG	ACTGAGCG	ATCGCA	ACTGAGCG
AGTCTC_ACTGAGCG	ACTGAGCG	AGTCTC	ACTGAGCG
CACACG_ACTGAGCG	ACTGAGCG	CACACG	ACTGAGCG
GCTACG_ACTGAGCG	ACTGAGCG	GCTACG	ACTGAGCG
GAGTCT_ACTGAGCG	ACTGAGCG	GAGTCT	ACTGAGCG
ACACGT_ACTGAGCG	ACTGAGCG	ACACGT	ACTGAGCG
ATCTGA_ACTGAGCG	ACTGAGCG	ATCTGA	ACTGAGCG
CACATA_ACTGAGCG	ACTGAGCG	CACATA	ACTGAGCG
GTAGCA_ACTGAGCG	ACTGAGCG	GTAGCA	ACTGAGCG
CGACGT_ACTGAGCG	ACTGAGCG	CGACGT	ACTGAGCG
GCTGCA_ACTGAGCG	ACTGAGCG	GCTGCA	ACTGAGCG
TATAGC_ACTGAGCG	ACTGAGCG	TATAGC	ACTGAGCG
CGACTC_ACTGAGCG	ACTGAGCG	CGACTC	ACTGAGCG
GCTAGC_ACTGAGCG	ACTGAGCG	GCTAGC	ACTGAGCG
ACACAG_ACTGAGCG	ACTGAGCG	ACACAG	ACTGAGCG
GTAGAT_ACTGAGCG	ACTGAGCG	GTAGAT	ACTGAGCG
GTACTC_ACTGAGCG	ACTGAGCG	GTACTC	ACTGAGCG
TATGTG_ACTGAGCG	ACTGAGCG	TATGTG	ACTGAGCG
GTACAG_ACTGAGCG	ACTGAGCG	GTACAG	ACTGAGCG
CTGCGT_ACTGAGCG	ACTGAGCG	CTGCGT	ACTGAGCG
ACAGTG_ACTGAGCG	ACTGAGCG	ACAGTG	ACTGAGCG
GTATAC_ACTGAGCG	ACTGAGCG	GTATAC	ACTGAGCG
GAGTAC_ACTGAGCG	ACTGAGCG	GAGTAC	ACTGAGCG
TATGCA_ACTGAGCG	ACTGAGCG	TATGCA	ACTGAGCG
GCTGAT_ACTGAGCG	ACTGAGCG	GCTGAT	ACTGAGCG
CACAGC_ACTGAGCG	ACTGAGCG	CACAGC	ACTGAGCG
ACAGAT_ACTGAGCG	ACTGAGCG	ACAGAT	ACTGAGCG
CGAGTG_ACTGAGCG	ACTGAGCG	CGAGTG	ACTGAGCG
GCTATA_ACTGAGCG	ACTGAGCG	GCTATA	ACTGAGCG
CTGCAG_ACTGAGCG	ACTGAGCG	CTGCAG	ACTGAGCG
CTGAGC_ACTGAGCG	ACTGAGCG	CTGAGC	ACTGAGCG
CACGAT_ACTGAGCG	ACTGAGCG	CACGAT	ACTGAGCG
TATACG_ACTGAGCG	ACTGAGCG	TATACG	ACTGAGCG
AGTGCA_ACTGAGCG	ACTGAGCG	AGTGCA	ACTGAGCG
ATCGAT_ACTGAGCG	ACTGAGCG	ATCGAT	ACTGAGCG
CACTCT_ACTGAGCG	ACTGAGCG	CACTCT	ACTGAGCG
CGATAC_ACTGAGCG	ACTGAGCG	CGATAC	ACTGAGCG
CTGTAC_ACTGAGCG	ACTGAGCG	CTGTAC	ACTGAGCG
ATCTCT_ACTGAGCG	ACTGAGCG	ATCTCT	ACTGAGCG
GCTCAG_ACTGAGCG	ACTGAGCG	GCTCAG	ACTGAGCG
GAGTGA_ACTGAGCG	ACTGAGCG	GAGTGA	ACTGAGCG
ATCACG_ACTGAGCG	ACTGAGCG	ATCACG	ACTGAGCG
ACAGCA_ACTGAGCG	ACTGAGCG	ACAGCA	ACTGAGCG
AGTGAT_ACTGAGCG	ACTGAGCG	AGTGAT	ACTGAGCG
ACATAC_ACTGAGCG	ACTGAGCG	ACATAC	ACTGAGCG
CGACAG_ACTGAGCG	ACTGAGCG	CGACAG	ACTGAGCG
AGTCGT_ACTGAGCG	ACTGAGCG	AGTCGT	ACTGAGCG
AGTAGC_ACTGAGCG	ACTGAGCG	AGTAGC	ACTGAGCG
GTACGT_ACTGAGCG	ACTGAGCG	GTACGT	ACTGAGCG
AGTACG_ACTGAGCG	ACTGAGCG	AGTACG	ACTGAGCG
CACTAC_ACTGAGCG	ACTGAGCG	CACTAC	ACTGAGCG
ACACTC_ACTGAGCG	ACTGAGCG	ACACTC	ACTGAGCG
GAGCAG_ACTGAGCG	ACTGAGCG	GAGCAG	ACTGAGCG
GTAGTG_ACTGAGCG	ACTGAGCG	GTAGTG	ACTGAGCG
AGTCAG_ACTGAGCG	ACTGAGCG	AGTCAG	ACTGAGCG
CTGACG_ACTGAGCG	ACTGAGCG	CTGACG	ACTGAGCG
GAGACG_ACTGAGCG	ACTGAGCG	GAGACG	ACTGAGCG
AGTGTG_ACTGAGCG	ACTGAGCG	AGTGTG	ACTGAGCG
CTGCTC_ACTGAGCG	ACTGAGCG	CTGCTC	ACTGAGCG
CGAGAT_ACTGAGCG	ACTGAGCG	CGAGAT	ACTGAGCG
GAGCGT_ACTGAGCG	ACTGAGCG	GAGCGT	ACTGAGCG
ATCTAC_ACTGAGCG	ACTGAGCG	ATCTAC	ACTGAGCG
CGAGCA_ACTGAGCG	ACTGAGCG	CGAGCA	ACTGAGCG
GAGTAC_CCTAAGAC	CCTAAGAC	GAGTAC	CCTAAGAC
TATAGC_CCTAAGAC	CCTAAGAC	TATAGC	CCTAAGAC
CGAGTG_CCTAAGAC	CCTAAGAC	CGAGTG	CCTAAGAC
CTGACG_CCTAAGAC	CCTAAGAC	CTGACG	CCTAAGAC
CACTCT_CCTAAGAC	CCTAAGAC	CACTCT	CCTAAGAC
GCTATA_CCTAAGAC	CCTAAGAC	GCTATA	CCTAAGAC
AGTAGC_CCTAAGAC	CCTAAGAC	AGTAGC	CCTAAGAC
ACAGCA_CCTAAGAC	CCTAAGAC	ACAGCA	CCTAAGAC
GTAGTG_CCTAAGAC	CCTAAGAC	GTAGTG	CCTAAGAC
CTGCAG_CCTAAGAC	CCTAAGAC	CTGCAG	CCTAAGAC
ATCGCA_CCTAAGAC	CCTAAGAC	ATCGCA	CCTAAGAC
ATCTAC_CCTAAGAC	CCTAAGAC	ATCTAC	CCTAAGAC
GAGTCT_CCTAAGAC	CCTAAGAC	GAGTCT	CCTAAGAC
GTAGCA_CCTAAGAC	CCTAAGAC	GTAGCA	CCTAAGAC
CACACG_CCTAAGAC	CCTAAGAC	CACACG	CCTAAGAC
CTGTAC_CCTAAGAC	CCTAAGAC	CTGTAC	CCTAAGAC
CTGCTC_CCTAAGAC	CCTAAGAC	CTGCTC	CCTAAGAC
CGAGAT_CCTAAGAC	CCTAAGAC	CGAGAT	CCTAAGAC
TATACG_CCTAAGAC	CCTAAGAC	TATACG	CCTAAGAC
TATGCA_CCTAAGAC	CCTAAGAC	TATGCA	CCTAAGAC
CGAGCA_CCTAAGAC	CCTAAGAC	CGAGCA	CCTAAGAC
GAGTGA_CCTAAGAC	CCTAAGAC	GAGTGA	CCTAAGAC
AGTACG_CCTAAGAC	CCTAAGAC	AGTACG	CCTAAGAC
AGTCTC_CCTAAGAC	CCTAAGAC	AGTCTC	CCTAAGAC
ACAGTG_CCTAAGAC	CCTAAGAC	ACAGTG	CCTAAGAC
GAGCGT_CCTAAGAC	CCTAAGAC	GAGCGT	CCTAAGAC
GCTACG_CCTAAGAC	CCTAAGAC	GCTACG	CCTAAGAC
CACATA_CCTAAGAC	CCTAAGAC	CACATA	CCTAAGAC
ATCTCT_CCTAAGAC	CCTAAGAC	ATCTCT	CCTAAGAC
GCTGCA_CCTAAGAC	CCTAAGAC	GCTGCA	CCTAAGAC
ATCGAT_CCTAAGAC	CCTAAGAC	ATCGAT	CCTAAGAC
ACATAC_CCTAAGAC	CCTAAGAC	ACATAC	CCTAAGAC
AGTGTG_CCTAAGAC	CCTAAGAC	AGTGTG	CCTAAGAC
CGACTC_CCTAAGAC	CCTAAGAC	CGACTC	CCTAAGAC
CGATAC_CCTAAGAC	CCTAAGAC	CGATAC	CCTAAGAC
CACAGC_CCTAAGAC	CCTAAGAC	CACAGC	CCTAAGAC
CACGCA_CCTAAGAC	CCTAAGAC	CACGCA	CCTAAGAC
GCTGAT_CCTAAGAC	CCTAAGAC	GCTGAT	CCTAAGAC
AGTGCA_CCTAAGAC	CCTAAGAC	AGTGCA	CCTAAGAC
ATCTGA_CCTAAGAC	CCTAAGAC	ATCTGA	CCTAAGAC
ACACGT_CCTAAGAC	CCTAAGAC	ACACGT	CCTAAGAC
GAGCAG_CCTAAGAC	CCTAAGAC	GAGCAG	CCTAAGAC
GAGACG_CCTAAGAC	CCTAAGAC	GAGACG	CCTAAGAC
ATCACG_CCTAAGAC	CCTAAGAC	ATCACG	CCTAAGAC
GCTAGC_CCTAAGAC	CCTAAGAC	GCTAGC	CCTAAGAC
CTGAGC_CCTAAGAC	CCTAAGAC	CTGAGC	CCTAAGAC
CACGAT_CCTAAGAC	CCTAAGAC	CACGAT	CCTAAGAC
CGACAG_CCTAAGAC	CCTAAGAC	CGACAG	CCTAAGAC
GTACTC_CCTAAGAC	CCTAAGAC	GTACTC	CCTAAGAC
AGTGAT_CCTAAGAC	CCTAAGAC	AGTGAT	CCTAAGAC
CTGCGT_CCTAAGAC	CCTAAGAC	CTGCGT	CCTAAGAC
ACACTC_CCTAAGAC	CCTAAGAC	ACACTC	CCTAAGAC
TATGTG_CCTAAGAC	CCTAAGAC	TATGTG	CCTAAGAC
ACACAG_CCTAAGAC	CCTAAGAC	ACACAG	CCTAAGAC
AGTCAG_CCTAAGAC	CCTAAGAC	AGTCAG	CCTAAGAC
CGACGT_CCTAAGAC	CCTAAGAC	CGACGT	CCTAAGAC
CACTAC_CCTAAGAC	CCTAAGAC	CACTAC	CCTAAGAC
GTATAC_CCTAAGAC	CCTAAGAC	GTATAC	CCTAAGAC
GTACAG_CCTAAGAC	CCTAAGAC	GTACAG	CCTAAGAC
GTACGT_CCTAAGAC	CCTAAGAC	GTACGT	CCTAAGAC
AGTCGT_CCTAAGAC	CCTAAGAC	AGTCGT	CCTAAGAC
GTAGAT_CCTAAGAC	CCTAAGAC	GTAGAT	CCTAAGAC
ACAGAT_CCTAAGAC	CCTAAGAC	ACAGAT	CCTAAGAC
GCTCAG_CCTAAGAC	CCTAAGAC	GCTCAG	CCTAAGAC
CGAGAT_CGATCAGT	CGATCAGT	CGAGAT	CGATCAGT
ATCGCA_CGATCAGT	CGATCAGT	ATCGCA	CGATCAGT
GTACTC_CGATCAGT	CGATCAGT	GTACTC	CGATCAGT
CACATA_CGATCAGT	CGATCAGT	CACATA	CGATCAGT
CGAGTG_CGATCAGT	CGATCAGT	CGAGTG	CGATCAGT
GAGCGT_CGATCAGT	CGATCAGT	GAGCGT	CGATCAGT
ATCGAT_CGATCAGT	CGATCAGT	ATCGAT	CGATCAGT
ATCTCT_CGATCAGT	CGATCAGT	ATCTCT	CGATCAGT
ACAGCA_CGATCAGT	CGATCAGT	ACAGCA	CGATCAGT
ACAGAT_CGATCAGT	CGATCAGT	ACAGAT	CGATCAGT
CGACAG_CGATCAGT	CGATCAGT	CGACAG	CGATCAGT
ACATAC_CGATCAGT	CGATCAGT	ACATAC	CGATCAGT
CACAGC_CGATCAGT	CGATCAGT	CACAGC	CGATCAGT
GAGTGA_CGATCAGT	CGATCAGT	GAGTGA	CGATCAGT
GTACAG_CGATCAGT	CGATCAGT	GTACAG	CGATCAGT
TATGCA_CGATCAGT	CGATCAGT	TATGCA	CGATCAGT
CACGAT_CGATCAGT	CGATCAGT	CACGAT	CGATCAGT
GTAGCA_CGATCAGT	CGATCAGT	GTAGCA	CGATCAGT
GAGTAC_CGATCAGT	CGATCAGT	GAGTAC	CGATCAGT
ATCTAC_CGATCAGT	CGATCAGT	ATCTAC	CGATCAGT
AGTCTC_CGATCAGT	CGATCAGT	AGTCTC	CGATCAGT
GTACGT_CGATCAGT	CGATCAGT	GTACGT	CGATCAGT
AGTACG_CGATCAGT	CGATCAGT	AGTACG	CGATCAGT
GTAGAT_CGATCAGT	CGATCAGT	GTAGAT	CGATCAGT
AGTGAT_CGATCAGT	CGATCAGT	AGTGAT	CGATCAGT
CTGCGT_CGATCAGT	CGATCAGT	CTGCGT	CGATCAGT
GCTGCA_CGATCAGT	CGATCAGT	GCTGCA	CGATCAGT
CACTCT_CGATCAGT	CGATCAGT	CACTCT	CGATCAGT
TATACG_CGATCAGT	CGATCAGT	TATACG	CGATCAGT
TATAGC_CGATCAGT	CGATCAGT	TATAGC	CGATCAGT
CGATAC_CGATCAGT	CGATCAGT	CGATAC	CGATCAGT
ACACGT_CGATCAGT	CGATCAGT	ACACGT	CGATCAGT
CGACTC_CGATCAGT	CGATCAGT	CGACTC	CGATCAGT
CTGACG_CGATCAGT	CGATCAGT	CTGACG	CGATCAGT
CGATCT_CGATCAGT	CGATCAGT	CGATCT	CGATCAGT
AGTGTG_CGATCAGT	CGATCAGT	AGTGTG	CGATCAGT
AGTCAG_CGATCAGT	CGATCAGT	AGTCAG	CGATCAGT
GCTACG_CGATCAGT	CGATCAGT	GCTACG	CGATCAGT
GAGACG_CGATCAGT	CGATCAGT	GAGACG	CGATCAGT
ATCACG_CGATCAGT	CGATCAGT	ATCACG	CGATCAGT
CTGTAC_CGATCAGT	CGATCAGT	CTGTAC	CGATCAGT
AGTAGC_CGATCAGT	CGATCAGT	AGTAGC	CGATCAGT
GAGTCT_CGATCAGT	CGATCAGT	GAGTCT	CGATCAGT
AGTCGT_CGATCAGT	CGATCAGT	AGTCGT	CGATCAGT
CACTAC_CGATCAGT	CGATCAGT	CACTAC	CGATCAGT
CACACG_CGATCAGT	CGATCAGT	CACACG	CGATCAGT
AGTGCA_CGATCAGT	CGATCAGT	AGTGCA	CGATCAGT
ACAGTG_CGATCAGT	CGATCAGT	ACAGTG	CGATCAGT
ACACAG_CGATCAGT	CGATCAGT	ACACAG	CGATCAGT
ACACTC_CGATCAGT	CGATCAGT	ACACTC	CGATCAGT
GAGCAG_CGATCAGT	CGATCAGT	GAGCAG	CGATCAGT
CTGCAG_CGATCAGT	CGATCAGT	CTGCAG	CGATCAGT
CGACGT_CGATCAGT	CGATCAGT	CGACGT	CGATCAGT
GTATAC_CGATCAGT	CGATCAGT	GTATAC	CGATCAGT
TATGTG_CGATCAGT	CGATCAGT	TATGTG	CGATCAGT
GCTAGC_CGATCAGT	CGATCAGT	GCTAGC	CGATCAGT
CTGCTC_CGATCAGT	CGATCAGT	CTGCTC	CGATCAGT
GCTCAG_CGATCAGT	CGATCAGT	GCTCAG	CGATCAGT
GCTATA_CGATCAGT	CGATCAGT	GCTATA	CGATCAGT
CGAGCA_CGATCAGT	CGATCAGT	CGAGCA	CGATCAGT
ATCTGA_CGATCAGT	CGATCAGT	ATCTGA	CGATCAGT
GTAGTG_CGATCAGT	CGATCAGT	GTAGTG	CGATCAGT
CTGAGC_CGATCAGT	CGATCAGT	CTGAGC	CGATCAGT
GCTGAT_CGATCAGT	CGATCAGT	GCTGAT	CGATCAGT
GTATAC_TGCAGCTA	TGCAGCTA	GTATAC	TGCAGCTA
CTGAGC_TGCAGCTA	TGCAGCTA	CTGAGC	TGCAGCTA
CGAGTG_TGCAGCTA	TGCAGCTA	CGAGTG	TGCAGCTA
GTAGAT_TGCAGCTA	TGCAGCTA	GTAGAT	TGCAGCTA
AGTGAT_TGCAGCTA	TGCAGCTA	AGTGAT	TGCAGCTA
TATACG_TGCAGCTA	TGCAGCTA	TATACG	TGCAGCTA
TATGCA_TGCAGCTA	TGCAGCTA	TATGCA	TGCAGCTA
CGACTC_TGCAGCTA	TGCAGCTA	CGACTC	TGCAGCTA
CACGAT_TGCAGCTA	TGCAGCTA	CACGAT	TGCAGCTA
GCTGAT_TGCAGCTA	TGCAGCTA	GCTGAT	TGCAGCTA
CTGACG_TGCAGCTA	TGCAGCTA	CTGACG	TGCAGCTA
AGTCAG_TGCAGCTA	TGCAGCTA	AGTCAG	TGCAGCTA
CTGCAG_TGCAGCTA	TGCAGCTA	CTGCAG	TGCAGCTA
AGTGCA_TGCAGCTA	TGCAGCTA	AGTGCA	TGCAGCTA
CTGCTC_TGCAGCTA	TGCAGCTA	CTGCTC	TGCAGCTA
GAGTAC_TGCAGCTA	TGCAGCTA	GAGTAC	TGCAGCTA
AGTAGC_TGCAGCTA	TGCAGCTA	AGTAGC	TGCAGCTA
TATAGC_TGCAGCTA	TGCAGCTA	TATAGC	TGCAGCTA
GCTGCA_TGCAGCTA	TGCAGCTA	GCTGCA	TGCAGCTA
ACATCT_TGCAGCTA	TGCAGCTA	ACATCT	TGCAGCTA
CACTAC_TGCAGCTA	TGCAGCTA	CACTAC	TGCAGCTA
GTAGTG_TGCAGCTA	TGCAGCTA	GTAGTG	TGCAGCTA
AGTACG_TGCAGCTA	TGCAGCTA	AGTACG	TGCAGCTA
ATCTGA_TGCAGCTA	TGCAGCTA	ATCTGA	TGCAGCTA
ATCACG_TGCAGCTA	TGCAGCTA	ATCACG	TGCAGCTA
GAGACG_TGCAGCTA	TGCAGCTA	GAGACG	TGCAGCTA
CTGTAC_TGCAGCTA	TGCAGCTA	CTGTAC	TGCAGCTA
AGTGTG_TGCAGCTA	TGCAGCTA	AGTGTG	TGCAGCTA
GAGTCT_TGCAGCTA	TGCAGCTA	GAGTCT	TGCAGCTA
GCTAGC_TGCAGCTA	TGCAGCTA	GCTAGC	TGCAGCTA
GCTCAG_TGCAGCTA	TGCAGCTA	GCTCAG	TGCAGCTA
GTACAG_TGCAGCTA	TGCAGCTA	GTACAG	TGCAGCTA
ATCGCA_TGCAGCTA	TGCAGCTA	ATCGCA	TGCAGCTA
AGTCTC_TGCAGCTA	TGCAGCTA	AGTCTC	TGCAGCTA
CACTCT_TGCAGCTA	TGCAGCTA	CACTCT	TGCAGCTA
GCTACG_TGCAGCTA	TGCAGCTA	GCTACG	TGCAGCTA
GTACGT_TGCAGCTA	TGCAGCTA	GTACGT	TGCAGCTA
ACATAC_TGCAGCTA	TGCAGCTA	ACATAC	TGCAGCTA
GAGTGA_TGCAGCTA	TGCAGCTA	GAGTGA	TGCAGCTA
ATCGAT_TGCAGCTA	TGCAGCTA	ATCGAT	TGCAGCTA
TATGTG_TGCAGCTA	TGCAGCTA	TATGTG	TGCAGCTA
ACACAG_TGCAGCTA	TGCAGCTA	ACACAG	TGCAGCTA
CACATA_TGCAGCTA	TGCAGCTA	CACATA	TGCAGCTA
GTACTC_TGCAGCTA	TGCAGCTA	GTACTC	TGCAGCTA
CGACGT_TGCAGCTA	TGCAGCTA	CGACGT	TGCAGCTA
ACACGT_TGCAGCTA	TGCAGCTA	ACACGT	TGCAGCTA
CGACAG_TGCAGCTA	TGCAGCTA	CGACAG	TGCAGCTA
ACACTC_TGCAGCTA	TGCAGCTA	ACACTC	TGCAGCTA
CTGCGT_TGCAGCTA	TGCAGCTA	CTGCGT	TGCAGCTA
CGAGCA_TGCAGCTA	TGCAGCTA	CGAGCA	TGCAGCTA
CGATAC_TGCAGCTA	TGCAGCTA	CGATAC	TGCAGCTA
ATCTAC_TGCAGCTA	TGCAGCTA	ATCTAC	TGCAGCTA
CACAGC_TGCAGCTA	TGCAGCTA	CACAGC	TGCAGCTA
GAGCGT_TGCAGCTA	TGCAGCTA	GAGCGT	TGCAGCTA
ACAGTG_TGCAGCTA	TGCAGCTA	ACAGTG	TGCAGCTA
GCTATA_TGCAGCTA	TGCAGCTA	GCTATA	TGCAGCTA
ACAGAT_TGCAGCTA	TGCAGCTA	ACAGAT	TGCAGCTA
ATCTCT_TGCAGCTA	TGCAGCTA	ATCTCT	TGCAGCTA
GTAGCA_TGCAGCTA	TGCAGCTA	GTAGCA	TGCAGCTA
CACACG_TGCAGCTA	TGCAGCTA	CACACG	TGCAGCTA
AGTCGT_TGCAGCTA	TGCAGCTA	AGTCGT	TGCAGCTA
ACAGCA_TGCAGCTA	TGCAGCTA	ACAGCA	TGCAGCTA
GAGCAG_TGCAGCTA	TGCAGCTA	GAGCAG	TGCAGCTA
CGAGAT_TGCAGCTA	TGCAGCTA	CGAGAT	TGCAGCTA
GTAGCA_TCGACGTC	TCGACGTC	GTAGCA	TCGACGTC
GTATCT_TCGACGTC	TCGACGTC	GTATCT	TCGACGTC
GTACAG_TCGACGTC	TCGACGTC	GTACAG	TCGACGTC
TATGCA_TCGACGTC	TCGACGTC	TATGCA	TCGACGTC
AGTGAT_TCGACGTC	TCGACGTC	AGTGAT	TCGACGTC
GCTACG_TCGACGTC	TCGACGTC	GCTACG	TCGACGTC
TATAGC_TCGACGTC	TCGACGTC	TATAGC	TCGACGTC
CTGAGC_TCGACGTC	TCGACGTC	CTGAGC	TCGACGTC
CGACGT_TCGACGTC	TCGACGTC	CGACGT	TCGACGTC
GTACTC_TCGACGTC	TCGACGTC	GTACTC	TCGACGTC
CTGTAC_TCGACGTC	TCGACGTC	CTGTAC	TCGACGTC
GTATAC_TCGACGTC	TCGACGTC	GTATAC	TCGACGTC
ACAGAT_TCGACGTC	TCGACGTC	ACAGAT	TCGACGTC
GAGTCT_TCGACGTC	TCGACGTC	GAGTCT	TCGACGTC
CGAGCA_TCGACGTC	TCGACGTC	CGAGCA	TCGACGTC
AGTACG_TCGACGTC	TCGACGTC	AGTACG	TCGACGTC
ACACGT_TCGACGTC	TCGACGTC	ACACGT	TCGACGTC
GAGTAC_TCGACGTC	TCGACGTC	GAGTAC	TCGACGTC
ATCACG_TCGACGTC	TCGACGTC	ATCACG	TCGACGTC
CGAGAT_TCGACGTC	TCGACGTC	CGAGAT	TCGACGTC
CTGCTC_TCGACGTC	TCGACGTC	CTGCTC	TCGACGTC
CACACG_TCGACGTC	TCGACGTC	CACACG	TCGACGTC
GCTAGC_TCGACGTC	TCGACGTC	GCTAGC	TCGACGTC
ACACTC_TCGACGTC	TCGACGTC	ACACTC	TCGACGTC
CTGCGT_TCGACGTC	TCGACGTC	CTGCGT	TCGACGTC
AGTGTG_TCGACGTC	TCGACGTC	AGTGTG	TCGACGTC
CACTAC_TCGACGTC	TCGACGTC	CACTAC	TCGACGTC
GAGACG_TCGACGTC	TCGACGTC	GAGACG	TCGACGTC
GAGCAG_TCGACGTC	TCGACGTC	GAGCAG	TCGACGTC
GCTGCA_TCGACGTC	TCGACGTC	GCTGCA	TCGACGTC
AGTAGC_TCGACGTC	TCGACGTC	AGTAGC	TCGACGTC
ACACAG_TCGACGTC	TCGACGTC	ACACAG	TCGACGTC
CGAGTG_TCGACGTC	TCGACGTC	CGAGTG	TCGACGTC
CACGAT_TCGACGTC	TCGACGTC	CACGAT	TCGACGTC
GAGCGT_TCGACGTC	TCGACGTC	GAGCGT	TCGACGTC
AGTCAG_TCGACGTC	TCGACGTC	AGTCAG	TCGACGTC
CGACAG_TCGACGTC	TCGACGTC	CGACAG	TCGACGTC
CGACTC_TCGACGTC	TCGACGTC	CGACTC	TCGACGTC
ATCGAT_TCGACGTC	TCGACGTC	ATCGAT	TCGACGTC
GCTGAT_TCGACGTC	TCGACGTC	GCTGAT	TCGACGTC
GCTCAG_TCGACGTC	TCGACGTC	GCTCAG	TCGACGTC
ACAGCA_TCGACGTC	TCGACGTC	ACAGCA	TCGACGTC
CACATA_TCGACGTC	TCGACGTC	CACATA	TCGACGTC
GTACGT_TCGACGTC	TCGACGTC	GTACGT	TCGACGTC
CGATAC_TCGACGTC	TCGACGTC	CGATAC	TCGACGTC
CTGACG_TCGACGTC	TCGACGTC	CTGACG	TCGACGTC
CACTCT_TCGACGTC	TCGACGTC	CACTCT	TCGACGTC
TATACG_TCGACGTC	TCGACGTC	TATACG	TCGACGTC
AGTCGT_TCGACGTC	TCGACGTC	AGTCGT	TCGACGTC
ATCGCA_TCGACGTC	TCGACGTC	ATCGCA	TCGACGTC
CACAGC_TCGACGTC	TCGACGTC	CACAGC	TCGACGTC
GCTATA_TCGACGTC	TCGACGTC	GCTATA	TCGACGTC
ATCTGA_TCGACGTC	TCGACGTC	ATCTGA	TCGACGTC
GAGTGA_TCGACGTC	TCGACGTC	GAGTGA	TCGACGTC
TATGTG_TCGACGTC	TCGACGTC	TATGTG	TCGACGTC
GTAGTG_TCGACGTC	TCGACGTC	GTAGTG	TCGACGTC
AGTGCA_TCGACGTC	TCGACGTC	AGTGCA	TCGACGTC
ACAGTG_TCGACGTC	TCGACGTC	ACAGTG	TCGACGTC
ATCTCT_TCGACGTC	TCGACGTC	ATCTCT	TCGACGTC
GTAGAT_TCGACGTC	TCGACGTC	GTAGAT	TCGACGTC
AGTCTC_TCGACGTC	TCGACGTC	AGTCTC	TCGACGTC
ATCTAC_TCGACGTC	TCGACGTC	ATCTAC	TCGACGTC
ACATAC_TCGACGTC	TCGACGTC	ACATAC	TCGACGTC
CTGCAG_TCGACGTC	TCGACGTC	CTGCAG	TCGACGTC
