samplename	group	barcode	index
ACACAG	ACACAG	ACACAG	TAGGCATG
ACACGT	ACACGT	ACACGT	TAGGCATG
ACACTC	ACACTC	ACACTC	TAGGCATG
ACAGAT	ACAGAT	ACAGAT	TAGGCATG
ACAGCA	ACAGCA	ACAGCA	TAGGCATG
ACAGTG	ACAGTG	ACAGTG	TAGGCATG
ACATAC	ACATAC	ACATAC	TAGGCATG
ACATCT	ACATCT	GCTGCA	TAGGCATG
ACATGA	ACATGA	GCTGTG	TAGGCATG
AGTACG	AGTACG	GTACAG	TAGGCATG
AGTAGC	AGTAGC	GTACGT	TAGGCATG
AGTATA	AGTATA	GTACTC	TAGGCATG
AGTCAG	AGTCAG	GTAGAT	TAGGCATG
AGTCGT	AGTCGT	GTAGCA	TAGGCATG
AGTCTC	AGTCTC	AGTCTC	TAGGCATG
AGTGAT	AGTGAT	AGTGAT	TAGGCATG
AGTGCA	AGTGCA	AGTGCA	TAGGCATG
AGTGTG	AGTGTG	AGTGTG	TAGGCATG
ATCACG	ATCACG	ATCACG	TAGGCATG
ATCAGC	ATCAGC	ATCAGC	TAGGCATG
ATCATA	ATCATA	ATCATA	TAGGCATG
ATCGAT	ATCGAT	ATCGAT	TAGGCATG
ATCGCA	ATCGCA	ATCGCA	TAGGCATG
ATCGTG	ATCGTG	ATCGTG	TAGGCATG
ATCTAC	ATCTAC	ATCTAC	TAGGCATG
ATCTCT	ATCTCT	ATCTCT	TAGGCATG
ATCTGA	ATCTGA	ATCTGA	TAGGCATG
CACACG	CACACG	CACACG	TAGGCATG
CACAGC	CACAGC	CACAGC	TAGGCATG
CACATA	CACATA	CACATA	TAGGCATG
CACGAT	CACGAT	CACGAT	TAGGCATG
CACGCA	CACGCA	CACGCA	TAGGCATG
CACGTG	CACGTG	CACGTG	TAGGCATG
CACTAC	CACTAC	CACTAC	TAGGCATG
CACTCT	CACTCT	CACTCT	TAGGCATG
CACTGA	CACTGA	CACTGA	TAGGCATG
CGACAG	CGACAG	CGACAG	TAGGCATG
CGACGT	CGACGT	CGACGT	TAGGCATG
CGACTC	CGACTC	CGACTC	TAGGCATG
CGAGAT	CGAGAT	CGAGAT	TAGGCATG
CGAGCA	CGAGCA	CGAGCA	TAGGCATG
CGAGTG	CGAGTG	CGAGTG	TAGGCATG
CGATAC	CGATAC	CGATAC	TAGGCATG
CGATCT	CGATCT	CGATCT	TAGGCATG
CGATGA	CGATGA	CGATGA	TAGGCATG
CTGACG	CTGACG	CTGACG	TAGGCATG
CTGAGC	CTGAGC	CTGAGC	TAGGCATG
CTGATA	CTGATA	CTGATA	TAGGCATG
CTGCAG	CTGCAG	CTGCAG	TAGGCATG
CTGCGT	CTGCGT	CTGCGT	TAGGCATG
CTGCTC	CTGCTC	CTGCTC	TAGGCATG
CTGTAC	CTGTAC	CTGTAC	TAGGCATG
CTGTCT	CTGTCT	CTGTCT	TAGGCATG
CTGTGA	CTGTGA	CTGTGA	TAGGCATG
GAGACG	GAGACG	GAGACG	TAGGCATG
GAGAGC	GAGAGC	GAGAGC	TAGGCATG
GAGATA	GAGATA	GAGATA	TAGGCATG
GAGCAG	GAGCAG	GAGCAG	TAGGCATG
GAGCGT	GAGCGT	GAGCGT	TAGGCATG
GAGCTC	GAGCTC	GAGCTC	TAGGCATG
GAGTAC	GAGTAC	GAGTAC	TAGGCATG
GAGTCT	GAGTCT	GAGTCT	TAGGCATG
GAGTGA	GAGTGA	GAGTGA	TAGGCATG
GCTACG	GCTACG	GCTACG	TAGGCATG
GCTAGC	GCTAGC	GCTAGC	TAGGCATG
GCTATA	GCTATA	GCTATA	TAGGCATG
GCTCAG	GCTCAG	GCTCAG	TAGGCATG
GCTCGT	GCTCGT	GCTCGT	TAGGCATG
GCTCTC	GCTCTC	GCTCTC	TAGGCATG
GCTGAT	GCTGAT	GCTGAT	TAGGCATG
